,BME,CDE,DWE,FGE,FRE,HPE,TVE,all_P
1,6,4548,0,132,113,1798,38,6635
2,7,4537,0,131,113,1793,38,6619
3,7,4554,0,131,107,1799,38,6636
4,6,4541,0,130,106,1,38,4822
5,6,4558,0,130,106,1,38,4839
6,7,4568,0,129,105,1,38,4848
7,6,4526,0,129,107,1,38,4807
8,6,4522,0,127,106,1,38,4800
9,7,4541,0,125,106,0,39,4818
10,7,4557,0,9,105,1,38,4717
11,6,4506,0,0,105,1,38,4656
12,6,4520,0,0,106,1,38,4671
13,7,4496,0,0,105,1,38,4647
14,6,4496,0,0,105,1,38,4646
15,6,4492,0,0,104,1,38,4641
16,6,4501,0,1,105,1,38,4652
17,6,4492,0,0,106,38,38,4680
18,6,4473,0,0,103,36,38,4656
19,6,4456,0,0,105,36,39,4642
20,6,4466,0,0,104,36,39,4651
21,6,4520,0,0,105,36,39,4706
22,7,4534,0,0,106,36,39,4722
23,6,4580,0,0,105,36,38,4765
24,7,4532,0,0,106,36,39,4720
25,7,4536,0,0,106,35,38,4722
26,6,4545,0,0,104,36,38,4729
27,6,4520,0,0,104,35,39,4704
28,6,4500,0,0,104,35,39,4684
29,6,4509,0,0,105,36,38,4694
30,6,4510,0,0,106,36,39,4697
31,6,4497,0,0,103,36,39,4681
32,7,4521,0,0,104,35,38,4705
33,6,4530,0,0,103,36,38,4713
34,6,4514,0,0,105,36,39,4700
35,6,4534,0,0,105,37,38,4720
36,6,4535,0,581,104,35,38,5299
37,6,4495,0,141,103,37,38,4820
38,6,4525,0,128,104,37,38,4838
39,7,4478,0,126,106,36,38,4791
40,6,4540,0,125,106,36,38,4851
41,7,4529,0,125,104,37,38,4840
42,7,4476,0,125,103,36,38,4785
43,6,4455,0,123,103,35,38,4760
44,6,4478,0,123,104,37,38,4786
45,6,4500,0,101,104,37,38,4786
46,7,4490,0,0,103,36,38,4674
47,7,4478,0,1,105,36,38,4665
48,7,274,0,0,104,37,39,461
49,7,253,0,0,106,37,37,440
50,7,259,0,0,104,37,38,445
51,429,4529,0,0,104,35,38,5135
52,410,4449,0,0,106,35,38,5038
53,430,255,0,0,104,36,38,863
54,434,252,0,0,106,36,39,867
55,424,252,0,0,105,36,38,855
56,419,263,0,0,105,35,39,861
57,430,261,0,0,103,36,38,868
58,434,269,0,0,105,36,38,882
59,437,274,0,0,104,36,38,889
60,424,273,0,0,107,37,38,879
61,333,271,0,0,106,37,38,785
62,328,275,0,0,106,35,38,782
63,325,1,0,0,106,36,38,506
64,326,0,0,0,105,36,38,505
65,329,0,0,0,105,36,39,509
66,328,0,0,0,106,36,38,508
67,324,0,0,0,105,35,38,502
68,329,0,0,6,105,36,38,514
69,325,0,0,0,105,36,39,505
70,325,0,0,0,104,35,38,502
71,329,0,0,0,106,37,39,511
72,326,0,0,0,106,36,38,506
73,325,0,0,0,105,36,38,504
74,325,0,0,145,106,35,38,649
75,326,0,0,131,106,36,38,637
76,327,1,0,128,105,36,38,635
77,326,1,0,126,106,36,38,633
78,325,0,0,125,106,37,39,632
79,329,0,0,126,104,37,38,634
80,325,0,0,125,106,35,38,629
81,328,1,0,123,106,37,38,633
82,324,0,0,201,105,36,38,704
83,323,0,0,124,106,37,38,628
84,328,0,0,6,105,36,38,513
85,323,0,0,6,113,1008,38,1488
86,326,1,0,6,113,1560,38,2044
87,325,0,0,7,113,1678,39,2162
88,325,1,0,7,114,1714,38,2199
89,326,0,0,6,114,1750,38,2234
90,323,1,0,6,113,1768,39,2250
91,322,0,0,6,113,1777,38,2256
92,323,0,0,6,113,1784,38,2264
93,325,0,0,156,106,1,39,627
94,328,1,0,140,106,1,39,615
95,321,0,0,134,105,1,38,599
96,324,0,0,134,106,1,38,603
97,325,0,0,134,106,1,38,604
98,324,1,0,134,105,1,38,603
99,326,0,0,133,106,1,38,604
100,326,1,0,131,104,1,39,602
101,7,0,0,132,106,0,38,283
102,6,0,0,131,106,1,38,282
103,7,0,0,130,106,1,38,282
104,7,1,0,130,106,1,38,283
105,7,1,0,131,106,39,38,322
106,6,1,0,130,105,38,38,318
107,7,0,0,130,107,37,38,319
108,7,1,0,129,104,37,38,316
109,7,0,0,129,106,37,38,317
110,7,0,0,7,104,36,39,193
111,7,0,0,7,106,37,38,195
112,7,0,0,7,106,37,38,195
113,7,0,0,7,105,37,39,195
114,6,1,0,7,104,36,38,192
115,7,0,0,7,105,36,39,194
116,7,0,0,7,106,38,39,197
117,7,0,0,7,107,36,38,195
118,7,0,0,7,106,36,39,195
119,7,0,0,148,106,37,38,336
120,7,0,0,135,106,36,38,322
121,7,1,0,132,106,37,38,321
122,7,0,0,129,105,36,38,315
123,7,0,0,128,106,36,39,316
124,7,0,0,126,106,36,39,314
125,6,0,0,125,106,36,39,312
126,7,0,0,124,106,36,39,312
127,7,0,0,124,106,35,39,311
128,7,0,0,122,106,37,38,310
129,7,0,0,0,106,36,39,188
130,6,0,0,0,106,37,38,187
131,6,1,0,0,106,36,39,188
132,6,1,0,0,106,37,38,188
133,7,1,0,0,104,35,38,185
134,7,0,0,0,105,37,39,188
135,7,1,0,0,106,36,39,189
136,7,0,0,0,106,36,38,187
137,7,0,0,0,115,1376,39,1537
138,6,0,0,0,114,1594,38,1752
139,7,2,0,0,114,1697,39,1859
140,7,1,0,0,113,1729,39,1889
141,7,0,0,0,114,1746,38,1905
142,6,0,0,0,114,1762,38,1920
143,7,2,0,0,114,1777,38,1938
144,6,0,0,0,114,1754,38,1912
145,7,0,0,0,112,1757,38,1914
146,7,0,0,0,113,1763,38,1921
147,7,0,0,0,114,1761,38,1920
148,7,0,0,0,115,1773,38,1933
149,6,1,0,0,113,1775,38,1933
150,6,0,0,0,114,1777,38,1935
151,7,0,0,0,113,1779,38,1937
152,7,1,0,0,114,1783,39,1944
153,6,1,0,0,114,1785,39,1945
154,7,0,0,0,114,1781,38,1940
155,6,1,0,0,113,1790,38,1948
156,6,1,0,0,113,1786,38,1944
157,7,1,0,0,113,1783,38,1942
158,6,0,0,0,112,1790,38,1946
159,7,1,0,148,113,1790,38,2097
160,7,0,0,134,106,1,39,287
161,7,0,0,127,107,1,38,280
162,7,1,0,127,106,1,38,280
163,6,0,0,126,107,0,38,277
164,6,0,0,125,106,0,38,275
165,6,1,0,124,105,1,39,276
166,7,0,0,123,106,1,38,275
167,7,0,0,122,106,1,38,274
168,7,1,0,121,105,1,38,273
169,6,0,0,0,105,1,39,151
170,6,0,0,0,105,1,39,151
171,6,0,0,0,105,1,39,151
172,7,0,0,0,105,1,38,151
173,6,0,0,0,106,1,38,151
174,6,0,0,0,106,0,38,150
175,7,1,0,0,105,38,38,189
176,7,0,0,0,106,36,38,187
177,7,1,0,0,105,37,39,189
178,7,0,0,1,105,36,38,187
179,6,0,0,10,106,36,38,196
180,6,0,0,0,103,36,39,184
181,6,0,0,0,106,36,38,186
182,7,0,0,0,104,36,38,185
183,7,0,0,0,104,35,38,184
184,6,1,0,0,105,36,39,187
185,7,1,0,0,106,36,38,188
186,7,1,0,10,105,36,38,197
187,7,0,0,7,104,35,38,191
188,7,0,0,7,105,36,38,193
189,7,0,0,7,103,36,38,191
190,7,1,0,156,105,36,38,343
191,7,0,0,139,105,36,38,325
192,7,0,0,137,104,35,38,321
193,7,0,0,135,104,36,39,321
194,7,0,0,133,105,37,39,321
195,6,0,0,133,105,36,38,318
196,7,0,0,132,106,37,38,320
197,7,1,0,132,105,36,38,319
198,6,0,0,132,105,35,38,316
199,89,0,0,132,104,36,38,399
200,6,0,0,133,106,36,38,319
201,6,0,0,132,106,37,38,319
202,7,0,0,131,107,36,38,319
203,7,0,0,132,107,37,38,321
204,6,1,0,130,106,37,38,318
205,7,0,0,129,106,36,37,315
206,328,1,0,128,107,36,38,638
207,327,0,0,128,106,36,38,635
208,327,0,0,128,107,36,39,637
209,328,0,0,6,106,37,39,516
210,329,1,0,6,106,36,39,517
211,329,0,0,7,106,36,39,517
212,330,0,0,6,106,37,38,517
213,329,1,0,6,105,36,38,515
214,330,0,0,6,106,36,39,517
215,330,0,0,7,106,37,38,518
216,331,0,0,7,105,37,39,519
217,330,0,0,6,106,36,38,516
218,331,0,0,148,106,37,38,660
219,331,0,0,136,106,36,38,647
220,330,1,0,134,106,36,38,645
221,328,0,0,132,106,38,38,642
222,327,0,0,129,105,36,38,635
223,326,0,0,127,106,36,39,634
224,326,0,0,126,106,38,39,635
225,325,0,0,124,106,37,39,631
226,330,0,0,123,106,36,38,633
227,331,0,0,123,105,37,39,635
228,331,0,0,122,106,36,38,633
229,329,0,0,122,106,36,39,632
230,330,0,0,0,106,36,39,511
231,330,0,0,0,106,36,38,510
232,331,0,0,0,106,37,39,513
233,330,1,0,0,106,37,38,512
234,331,0,0,0,106,36,38,511
235,329,0,0,0,106,37,38,510
236,331,0,0,0,105,37,38,511
237,442,2,0,0,107,37,38,626
238,431,0,0,0,106,36,38,611
239,429,1,0,0,106,38,38,612
240,435,0,0,0,106,36,39,616
241,430,0,0,0,106,38,39,613
242,430,0,0,0,106,37,38,611
243,427,0,0,0,106,37,39,609
244,436,1,0,0,104,37,38,616
245,419,0,0,0,105,36,39,599
246,421,1,0,0,115,1426,38,2001
247,414,0,0,0,114,1600,39,2167
248,419,0,0,0,113,1710,38,2280
249,413,1,0,0,113,1741,38,2306
250,392,0,0,0,113,1763,38,2306
251,390,0,0,0,114,1776,39,2319
252,424,0,0,0,115,1782,38,2359
253,414,0,0,0,114,1757,38,2323
254,413,0,0,0,114,1760,39,2326
255,413,0,0,0,113,1767,39,2332
256,94,0,0,0,114,1767,39,2014
257,432,0,0,0,113,1779,38,2362
258,421,0,0,0,113,1782,38,2354
259,425,0,0,0,114,1781,38,2358
260,421,0,0,140,113,1783,38,2495
261,432,0,0,131,114,1789,38,2504
262,426,0,0,128,113,1783,38,2488
263,420,0,0,127,113,1789,38,2487
264,419,0,0,125,113,1793,38,2488
265,428,0,0,123,113,1792,38,2494
266,421,1,0,123,113,1797,38,2493
267,430,1,0,122,113,1793,38,2497
268,422,0,0,121,112,1799,38,2492
269,429,0,0,0,106,0,38,573
270,424,0,0,0,107,1,38,570
271,432,1,0,0,107,1,39,580
272,433,0,0,0,106,1,38,578
273,438,1,0,0,106,1,38,584
274,434,1,0,0,107,1,38,581
275,429,0,0,0,105,1,38,573
276,422,1,0,0,107,1,38,569
277,422,1,0,0,106,1,38,568
278,416,1,0,0,106,1,39,563
279,430,0,0,79,107,1,227,844
280,423,0,0,0,105,0,228,756
281,418,1,0,10,106,0,310,845
282,425,1,0,0,107,1,213,747
283,419,0,0,0,106,1,224,750
284,417,0,0,0,107,38,240,802
285,419,2,0,0,106,36,218,781
286,393,0,0,0,106,36,219,754
287,394,1,0,0,106,38,214,753
288,398,1,0,0,106,38,227,770
289,395,0,0,0,106,36,227,764
290,390,1,0,0,106,36,219,752
291,391,0,0,0,105,36,212,744
292,393,0,0,0,106,37,221,757
293,399,0,0,0,106,37,238,780
294,389,0,0,143,105,37,281,955
295,390,0,0,130,105,36,364,1025
296,389,0,0,127,106,36,249,907
297,393,0,0,126,106,36,237,898
298,391,0,0,129,106,36,293,955
299,393,0,0,129,106,36,361,1025
300,394,0,0,130,106,37,250,917
301,392,1,0,129,106,36,374,1038
302,393,0,0,129,106,36,359,1023
303,392,0,0,128,105,38,306,969
304,393,1,0,128,106,38,280,946
305,393,0,0,7,107,36,229,772
306,332,0,0,7,106,37,213,695
307,331,0,0,7,114,1418,252,2122
308,333,0,0,6,114,1614,386,2453
309,333,0,0,7,114,1713,262,2429
310,334,0,0,6,114,1760,218,2432
311,333,1,0,6,115,1774,219,2448
312,334,0,0,6,114,1786,270,2510
313,331,1,0,6,114,1760,363,2575
314,333,1,0,147,114,1771,246,2612
315,332,0,0,138,113,1768,316,2667
316,333,1,0,136,114,1781,290,2655
317,331,0,0,133,113,1781,235,2593
318,333,0,0,134,114,1789,252,2622
319,334,0,0,133,114,1790,289,2660
320,333,0,0,132,114,1789,233,2601
321,333,0,0,132,114,1797,247,2623
322,334,0,0,131,114,1797,245,2621
323,334,1,0,131,113,1800,372,2751
324,334,0,0,130,114,1801,235,2614
325,334,0,0,130,114,1803,263,2644
326,334,0,0,129,114,1810,265,2652
327,333,1,0,130,114,1807,327,2712
328,334,0,0,129,114,1806,249,2632
329,335,0,0,127,107,1,222,792
330,336,0,0,124,106,0,288,854
331,334,0,0,0,108,1,387,830
332,334,0,0,0,107,1,207,649
333,334,0,0,0,106,1,225,666
334,335,0,0,0,107,1,213,656
335,335,1,0,0,106,1,211,654
336,337,0,0,0,107,1,241,686
337,337,0,0,0,107,0,212,656
338,338,0,0,0,107,1,226,672
339,337,1,0,0,107,1,214,660
340,338,0,0,0,108,1,228,675
341,335,0,0,0,106,1,206,648
342,335,1,0,0,107,1,211,655
343,334,0,0,0,106,1,222,663
344,334,0,0,0,107,39,338,818
345,334,0,0,0,106,38,207,685
346,334,0,0,0,106,38,226,704
347,333,0,0,0,107,37,235,712
348,333,1,0,0,106,38,212,690
349,333,1,0,0,106,36,214,690
350,334,0,0,0,106,38,225,703
351,334,1,0,0,106,38,219,698
352,334,0,0,0,106,37,223,700
353,334,1,0,0,106,37,212,690
354,334,0,0,0,106,37,224,701
355,334,0,0,0,106,38,228,706
356,334,1,0,142,106,36,212,831
357,335,0,0,131,106,37,212,821
358,333,0,0,127,105,37,225,827
359,332,0,0,127,106,36,210,811
360,333,0,0,125,106,36,228,828
361,332,1,0,124,105,37,222,821
362,333,1,0,123,106,37,205,805
363,336,1,0,123,107,37,212,816
364,336,0,0,122,108,37,209,812
365,337,0,0,0,107,37,209,690
366,337,0,0,0,106,37,212,692
367,336,2,0,0,106,37,219,700
368,334,0,0,0,106,36,214,690
369,333,0,0,0,106,37,216,692
370,334,0,0,0,106,37,212,689
371,336,0,0,0,107,37,204,684
372,335,0,0,0,107,37,265,744
373,336,0,0,0,106,38,202,682
374,336,0,0,0,109,38,348,831
375,336,0,0,0,107,37,202,682
376,334,1,0,0,106,37,236,714
377,335,0,0,0,107,37,254,733
378,333,0,0,0,114,1478,206,2131
379,334,1,0,0,114,1648,255,2352
380,335,1,0,0,114,1730,242,2422
381,336,0,0,0,114,1763,337,2550
382,334,0,0,0,115,1778,396,2623
383,332,0,0,0,113,1785,391,2621
384,331,1,0,0,114,1761,233,2440
385,330,0,0,0,113,1770,248,2461
386,332,0,0,0,114,1775,281,2502
387,332,1,0,0,114,1783,211,2441
388,331,1,0,0,113,1785,236,2466
389,332,0,0,10,114,1789,276,2521
390,333,0,0,0,114,1793,364,2604
391,332,0,0,0,114,1798,306,2550
392,334,0,0,0,113,1800,263,2510
393,333,0,0,0,115,1803,373,2624
394,334,0,0,144,114,1801,332,2725
395,335,0,0,131,114,1805,218,2603
396,334,0,0,127,114,1807,245,2627
397,335,1,0,127,114,1807,212,2596
398,335,0,0,127,114,1808,237,2621
399,335,1,0,125,114,1806,235,2616
400,335,0,0,124,114,1813,215,2601
401,336,0,0,124,108,1,270,839
402,336,0,0,122,106,0,381,945
403,336,1,0,0,108,1,268,714
404,336,0,0,0,108,0,244,688
405,335,0,0,0,108,1,306,750
406,336,0,0,0,107,1,273,717
407,336,1,0,0,108,1,264,710
408,337,0,0,0,107,0,244,688
409,339,1,0,0,106,1,271,718
410,333,0,0,0,106,1,260,700
411,331,1,0,0,106,1,236,675
412,331,0,0,0,106,0,364,801
413,329,0,0,0,106,0,265,700
414,331,0,0,0,107,1,308,747
415,330,0,0,0,106,0,239,675
416,330,1,0,0,107,38,238,714
417,333,9,0,0,108,38,37,525
418,354,2,0,0,106,37,37,536
419,352,0,0,0,107,36,37,532
420,352,0,0,0,106,37,37,532
421,352,0,0,0,106,36,37,531
422,354,0,0,0,107,37,37,535
423,354,1,0,0,107,38,37,537
424,354,1,0,0,106,37,37,535
425,352,0,0,0,106,36,37,531
426,459,0,0,0,108,36,37,640
427,454,0,0,0,106,37,37,634
428,445,0,0,0,105,37,38,625
429,440,0,0,0,106,37,38,621
430,444,0,0,0,106,36,38,624
431,444,0,0,0,106,36,38,624
432,451,0,0,0,106,36,37,630
433,443,0,0,0,106,37,38,624
434,456,0,0,0,115,1429,38,2038
435,447,0,0,143,114,1630,38,2372
436,455,0,0,130,114,1719,37,2455
437,454,0,0,127,114,1753,37,2485
438,447,0,0,127,113,1773,38,2498
439,440,0,0,125,114,1757,37,2473
440,452,0,0,124,113,1761,38,2488
441,443,0,0,123,113,1771,38,2488
442,446,0,0,122,114,1776,37,2495
443,453,0,0,122,113,1783,38,2509
444,456,0,0,0,114,1792,37,2399
445,459,0,0,0,114,1790,37,2400
446,444,0,0,0,115,1795,38,2392
447,449,1,0,0,115,1799,38,2402
448,447,0,0,0,114,1798,38,2397
449,451,0,0,10,114,1802,38,2415
450,454,0,0,9,114,1808,38,2423
451,445,0,0,0,114,1807,38,2404
452,444,0,0,0,113,1807,38,2402
453,445,1,0,0,114,1809,37,2406
454,455,0,0,0,114,1811,38,2418
455,454,1,0,0,114,1816,37,2422
456,456,0,0,0,114,1815,37,2422
457,452,1,0,0,114,1815,38,2420
458,452,0,0,0,106,0,38,596
459,444,1,0,0,108,1,39,593
460,438,1,0,0,106,1,37,583
461,451,0,0,0,106,1,38,596
462,451,0,0,0,107,0,38,596
463,452,1,0,10,107,0,37,607
464,457,0,0,6,108,1,37,609
465,456,1,0,7,106,1,37,608
466,459,1,0,6,106,1,38,611
467,455,0,0,6,106,1,38,606
468,454,0,0,148,106,1,38,747
469,456,0,0,137,106,1,38,738
470,455,0,0,135,106,1,38,735
471,452,1,0,134,106,1,38,732
472,460,1,0,133,106,1,38,739
473,49,1,0,133,107,1,38,329
474,27,0,0,132,106,41,38,344
475,27,0,0,132,106,39,38,342
476,27,0,0,132,106,38,38,341
477,27,0,0,131,106,38,38,340
478,27,0,0,130,106,37,38,338
479,27,0,0,130,107,38,37,339
480,27,0,0,130,106,37,38,338
481,7,0,0,130,106,38,37,318
482,7,0,0,129,106,37,37,316
483,7,2,0,129,107,38,37,320
484,7,0,0,7,106,38,38,196
485,7,0,0,7,107,38,39,198
486,7,0,0,7,106,38,38,196
487,7,0,0,7,107,37,39,197
488,7,0,0,7,106,37,38,195
489,7,1,0,7,107,37,38,197
490,7,0,0,7,106,38,38,196
491,7,0,0,7,106,38,38,196
492,7,1,0,10,114,2813,37,2982
493,7,1,0,148,114,1557,38,1865
494,6,0,0,135,115,1696,38,1990
495,6,0,0,131,114,1754,38,2043
496,6,0,0,129,115,1775,38,2063
497,7,0,0,130,113,1753,37,2040
498,7,0,0,128,115,1763,39,2052
499,7,0,0,127,115,1777,37,2063
500,7,0,0,124,113,1784,38,2066
501,7,0,0,123,114,1786,38,2068
502,7,0,0,122,114,1790,38,2071
503,7,0,0,1,113,1798,38,1957
504,6,1,0,0,114,1798,38,1957
505,7,1,0,0,113,1802,38,1961
506,7,1,0,0,113,1807,38,1966
507,6,0,0,0,113,1810,37,1966
508,6,2,0,0,114,1811,38,1971
509,7,0,0,1,114,1813,38,1973
510,7,0,0,0,115,1814,38,1974
511,7,0,0,0,114,1818,37,1976
512,6,0,0,0,114,1817,38,1975
513,7,0,0,0,114,1821,37,1979
514,7,0,0,0,114,1822,37,1980
515,7,0,0,1,114,1824,37,1983
516,7,2,0,0,114,1822,38,1983
517,7,0,0,0,114,1821,39,1981
518,6,0,0,0,107,1,38,152
519,6,1,0,0,107,1,37,152
520,7,0,0,0,106,1,38,152
521,7,1,0,0,106,1,39,154
522,7,0,0,0,107,1,38,153
523,7,1,0,0,106,1,37,152
524,7,1,0,0,106,1,38,153
525,7,0,0,1,107,1,39,155
526,7,1,0,0,107,1,38,154
527,7,0,0,0,106,0,38,151
528,7,0,0,0,106,1,39,153
529,7,0,0,0,107,1,39,154
530,7,1,0,0,107,1,38,154
531,6,0,0,0,106,1,38,151
532,6,0,0,0,106,1,38,151
533,7,0,0,0,108,1,37,153
534,7,0,0,148,106,1,37,299
535,7,0,0,138,106,1,38,290
536,7,1,0,128,106,41,37,320
537,7,0,0,127,105,38,38,315
538,7,0,0,126,106,37,38,314
539,7,0,0,127,106,38,38,316
540,7,0,0,125,106,38,38,314
541,7,0,0,124,106,38,38,313
542,7,0,0,123,106,38,37,311
543,7,0,0,0,106,37,37,187
544,6,0,0,1,106,38,38,189
545,6,0,0,0,107,37,38,188
546,7,0,0,0,107,38,38,190
547,7,1,0,1,106,38,38,191
548,7,0,0,0,106,37,38,188
549,7,0,0,0,106,37,38,188
550,7,0,0,0,106,38,38,189
551,6,0,0,0,106,37,37,186
552,7,0,0,10,114,1544,38,1713
553,7,0,0,7,115,1698,38,1865
554,7,0,0,0,115,1759,37,1918
555,7,0,0,0,115,1781,38,1941
556,7,1,0,0,114,1790,38,1950
557,7,1,0,0,114,1800,37,1959
558,7,0,0,0,114,1777,38,1936
559,7,1,0,0,115,1787,38,1948
560,7,0,0,0,114,1791,39,1951
561,7,0,0,0,115,1795,38,1955
562,7,0,0,0,114,1801,38,1960
563,6,0,0,1,114,1802,38,1961
564,7,0,0,0,114,1806,38,1965
565,7,0,0,0,114,1810,37,1968
566,7,0,0,0,113,1813,39,1972
567,7,0,0,0,114,1811,37,1969
568,7,0,0,0,114,1815,38,1974
569,6,0,0,0,115,1816,38,1975
570,7,1,0,0,114,1818,38,1978
571,7,0,0,144,114,1816,38,2119
572,7,0,0,131,114,1824,38,2114
573,7,0,0,128,115,1823,37,2110
574,7,0,0,127,113,1821,38,2106
575,7,0,0,126,114,1824,38,2109
576,7,0,0,125,114,1824,38,2108
577,7,0,0,125,114,1826,38,2110
578,6,0,0,123,115,1830,38,2112
579,7,0,0,122,108,1,37,275
580,6,1,0,0,106,1,37,151
581,7,0,0,0,108,1,38,154
582,7,1,0,1,107,1,38,155
583,7,0,0,0,107,1,38,153
584,6,0,0,0,107,1,38,152
585,6,1,0,0,107,1,37,152
586,7,1,0,0,107,1,38,154
587,7,1,0,0,106,1,38,153
588,7,1,0,1,106,1,37,153
589,7,0,0,0,106,1,38,152
590,7,0,0,0,106,1,38,152
591,7,0,0,0,106,1,38,152
592,7,0,0,0,106,1,37,151
593,7,0,0,0,107,1,37,152
594,7,0,0,0,106,1,38,152
595,7,0,0,0,107,1,38,153
596,7,0,0,0,107,1,38,153
597,7,0,0,0,107,41,37,192
598,7,1,0,0,107,39,38,192
599,7,0,0,0,106,39,38,190
600,7,1,0,0,105,39,37,189
601,6,0,0,1,106,38,38,189
602,6,1,0,0,106,38,37,188
603,6,0,0,0,105,37,37,185
604,7,0,0,0,106,38,37,188
605,7,0,0,0,106,37,37,187
606,7,0,0,0,106,38,38,189
607,7,1,0,0,106,38,38,190
608,7,1,0,0,106,38,39,191
609,7,2,0,0,114,1048,39,1210
610,7,0,0,0,115,1588,38,1748
611,7,0,0,0,115,1715,38,1875
612,7,0,0,0,115,1763,37,1922
613,7,1,0,144,115,1784,38,2089
614,7,1,0,132,114,1799,37,2090
615,7,0,0,128,114,1773,38,2060
616,7,0,0,128,115,1789,39,2078
617,7,0,0,127,114,1791,38,2077
618,7,0,0,127,114,1799,37,2084
619,7,0,0,125,115,1800,38,2085
620,7,1,0,124,114,1805,38,2089
621,7,0,0,123,114,1808,39,2091
622,7,0,0,0,115,1810,37,1969
623,7,0,0,0,115,1813,38,1973
624,7,0,0,0,114,1816,37,1974
625,7,0,0,0,114,1816,38,1975
626,6,0,0,0,115,1817,38,1976
627,7,0,0,0,115,1821,38,1981
628,6,0,0,1,114,1819,38,1978
629,7,1,0,0,114,1824,37,1983
630,7,1,0,0,114,1824,38,1984
631,7,0,0,1,114,1825,38,1985
632,7,1,0,0,114,1825,38,1985
633,7,0,0,0,113,1827,37,1984
634,7,0,0,0,114,1826,37,1984
635,7,0,0,10,114,1829,38,1998
636,7,0,0,7,107,1,38,160
637,7,0,0,7,108,1,37,160
638,7,1,0,7,106,1,38,160
639,7,0,0,7,106,1,37,158
640,7,0,0,7,107,1,37,159
641,7,1,0,7,107,1,37,160
642,7,2,0,7,108,1,38,163
643,7,0,0,151,107,1,38,304
644,7,1,0,142,107,0,38,295
645,7,1,0,137,106,0,38,289
646,7,1,0,136,106,0,38,288
647,7,1,0,135,106,1,38,288
648,6,0,0,134,107,1,38,286
649,7,0,0,133,107,1,38,286
650,7,0,0,133,106,1,37,284
651,7,0,0,134,106,1,37,285
652,6,0,0,133,106,1,38,284
653,6,0,0,131,107,41,38,323
654,7,0,0,131,106,39,37,320
655,7,0,0,130,106,39,38,320
656,7,0,0,131,106,38,38,320
657,7,0,0,129,104,38,37,315
658,7,1,0,130,106,37,38,319
659,6,0,0,129,106,37,38,316
660,7,0,0,7,106,38,38,196
661,7,1,0,7,104,37,38,194
662,7,0,0,7,105,36,38,193
663,7,0,0,7,106,37,38,195
664,7,1,0,7,106,38,38,197
665,7,0,0,0,107,37,38,189
666,7,0,0,0,105,38,38,188
667,6,0,0,0,105,38,37,186
668,7,1,0,0,106,38,38,190
669,7,0,0,0,105,38,38,188
670,6,0,0,1,105,38,38,188
671,7,0,0,148,107,37,37,336
672,7,0,0,133,106,38,38,322
673,7,1,0,130,105,37,37,317
674,7,0,0,128,103,37,37,312
675,7,0,0,126,104,36,37,310
676,7,0,0,125,115,1500,38,1785
677,7,0,0,124,115,1670,37,1953
678,7,1,0,123,114,1744,37,2026
679,6,0,0,122,114,1770,38,2050
680,7,0,0,0,114,1741,38,1900
681,7,0,0,0,114,1762,38,1921
682,7,1,0,0,116,1759,37,1920
683,7,0,0,0,114,1771,38,1930
684,7,0,0,0,115,1776,37,1935
685,7,1,0,0,115,1782,37,1942
686,7,1,0,0,114,1791,38,1951
687,6,0,0,1,115,1790,38,1950
688,7,0,0,0,115,1786,38,1946
689,7,0,0,0,114,1795,37,1953
690,7,1,0,0,115,1795,38,1956
691,6,0,0,0,114,1795,38,1953
692,7,0,0,0,114,1801,38,1960
693,7,1,0,0,115,1802,38,1963
694,7,1,0,0,114,1801,38,1961
695,7,0,0,1,114,1798,38,1958
696,7,0,0,0,115,1802,38,1962
697,7,0,0,0,115,1800,38,1960
698,7,0,0,0,114,1799,37,1957
699,7,0,0,0,114,1802,38,1961
700,6,1,0,1,115,1803,38,1964
701,7,0,0,0,114,1805,37,1963
702,7,0,0,0,114,1805,37,1963
703,7,1,0,0,114,1806,38,1966
704,7,1,0,0,115,1802,38,1963
705,7,0,0,0,114,1806,38,1965
706,7,0,0,0,114,1803,38,1962
707,6,0,0,0,114,1806,37,1963
708,7,0,0,0,107,0,38,152
709,7,0,0,0,107,1,38,153
710,7,0,0,0,106,0,38,151
711,7,0,0,0,106,1,38,152
712,7,0,0,145,106,1,37,296
713,6,0,0,133,106,0,37,282
714,7,0,0,128,106,1,38,280
715,7,1,0,126,106,1,37,278
716,6,0,0,126,106,1,37,276
717,7,0,0,126,106,1,38,278
718,7,1,0,124,105,1,37,275
719,7,1,0,123,105,1,37,274
720,7,0,0,123,106,1,39,276
721,6,1,0,0,104,42,38,191
722,7,0,0,0,104,38,37,186
723,7,0,0,0,104,37,38,186
724,7,0,0,7,104,38,38,194
725,7,0,0,1,106,37,38,189
726,7,2,0,0,105,38,38,190
727,7,0,0,0,105,38,37,187
728,7,0,0,0,105,36,38,186
729,6,1,0,0,106,37,37,187
730,6,1,0,1,104,38,38,188
731,7,0,0,0,104,37,38,186
732,6,0,0,0,105,36,39,186
733,7,0,0,0,104,37,38,186
734,7,1,0,0,104,38,38,188
735,7,1,0,0,105,36,38,187
736,6,0,0,0,103,38,38,185
737,6,0,0,0,103,38,37,184
738,7,0,0,0,104,37,38,186
739,7,0,0,0,104,37,37,185
740,7,0,0,0,104,37,38,186
741,6,0,0,0,104,38,38,186
742,7,0,0,0,105,37,37,186
743,7,0,0,0,116,1580,38,1741
744,7,0,0,0,114,1661,37,1819
745,7,0,0,1,115,1731,37,1891
746,6,0,0,0,115,1761,38,1920
747,6,0,0,0,114,1777,37,1934
748,7,1,0,0,114,1787,38,1947
749,7,0,0,148,115,1760,39,2069
750,7,1,0,135,115,1770,38,2066
751,7,1,0,131,115,1770,37,2061
752,7,1,0,127,115,1778,38,2066
753,7,0,0,127,114,1779,38,2065
754,7,0,0,125,114,1783,38,2067
755,7,1,0,124,114,1784,37,2067
756,6,2,0,124,115,1789,37,2073
757,7,0,0,122,113,1789,38,2069
758,7,0,0,0,115,1790,38,1950
759,7,0,0,0,115,1794,37,1953
760,6,0,0,0,115,1799,38,1958
761,7,0,0,0,114,1793,38,1952
762,7,0,0,0,114,1799,38,1958
763,7,0,0,0,114,1800,38,1959
764,7,0,0,0,115,1801,38,1961
765,7,0,0,0,114,1799,37,1957
766,6,1,0,1,115,1803,38,1964
767,7,1,0,0,115,1801,38,1962
768,7,0,0,0,115,1802,38,1962
769,7,0,0,0,115,1805,38,1965
770,6,0,0,0,114,1807,37,1964
771,7,1,0,0,115,1806,38,1967
772,7,1,0,1,115,1803,37,1964
773,7,0,0,0,115,1809,38,1969
774,7,0,0,0,114,1809,38,1968
775,7,0,0,0,115,1809,38,1969
776,7,0,0,0,114,1807,38,1966
777,7,1,0,0,107,1,38,154
778,7,0,0,0,107,1,38,153
779,7,0,0,0,107,1,38,153
780,7,2,0,0,106,1,37,153
781,7,0,0,0,105,1,38,151
782,7,0,0,0,106,1,38,152
783,7,0,0,1,106,1,38,153
784,7,1,0,0,106,1,38,153
785,7,0,0,10,104,1,38,160
786,7,0,0,0,105,1,38,151
787,7,0,0,0,104,1,38,150
788,7,0,0,0,104,1,38,150
789,7,0,0,0,105,0,38,150
790,7,1,0,143,105,41,38,335
791,7,0,0,132,104,39,38,320
792,7,0,0,129,104,38,37,315
793,7,0,0,127,105,37,38,314
794,7,1,0,126,105,38,38,315
795,7,1,0,126,105,38,38,315
796,7,0,0,124,104,38,38,311
797,7,0,0,124,104,37,37,309
798,7,0,0,123,104,38,38,310
799,7,1,0,0,104,37,37,186
800,7,0,0,0,104,38,38,187
801,7,0,0,0,104,38,38,187
802,7,0,0,0,104,37,38,186
803,7,0,0,0,103,37,38,185
804,7,0,0,0,104,38,38,187
805,7,0,0,0,104,38,38,187
806,7,0,0,0,104,37,39,187
807,7,0,0,0,104,37,38,186
808,6,1,0,0,104,38,38,187
809,7,1,0,0,103,37,37,185
810,7,0,0,7,104,38,37,193
811,6,0,0,7,114,1586,38,1751
812,7,0,0,7,114,1665,39,1832
813,6,0,0,7,115,1720,38,1886
814,6,0,0,7,114,1746,38,1911
815,7,0,0,7,113,1753,37,1917
816,6,0,0,7,114,1773,39,1939
817,7,0,0,7,115,1738,38,1905
818,7,0,0,153,114,1751,37,2062
819,7,0,0,142,114,1758,38,2059
820,6,0,0,137,114,1763,38,2058
821,7,0,0,136,113,1769,37,2062
822,7,0,0,134,114,1776,37,2068
823,7,0,0,133,114,1777,37,2068
824,7,0,0,132,114,1783,38,2074
825,7,0,0,132,114,1785,37,2075
826,7,0,0,132,115,1786,38,2078
827,7,0,0,131,114,1787,37,2076
828,7,0,0,131,113,1790,38,2079
829,7,0,0,131,114,1790,38,2080
830,7,0,0,130,114,1792,38,2081
831,7,0,0,130,114,1793,38,2082
832,7,1,0,131,114,1797,38,2088
833,7,0,0,131,114,1797,38,2087
834,7,1,0,128,114,1799,38,2087
835,6,0,0,7,114,1802,38,1967
836,7,0,0,7,114,1799,38,1965
837,6,0,0,7,114,1800,38,1965
838,6,0,0,10,114,1803,38,1971
839,6,1,0,0,114,1806,37,1964
840,7,1,0,0,114,1803,37,1962
841,7,0,0,0,113,1806,38,1964
842,7,0,0,0,113,1805,38,1963
843,6,0,0,0,114,1807,37,1964
844,7,1,0,0,106,0,37,151
845,7,0,0,0,106,1,38,152
846,7,0,0,145,105,0,38,295
847,7,0,0,131,105,1,38,282
848,7,1,0,128,104,1,38,279
849,7,0,0,127,104,1,38,277
850,7,0,0,126,104,1,38,276
851,7,0,0,124,104,1,37,273
852,6,1,0,123,104,1,38,273
853,7,0,0,123,103,1,37,271
854,7,0,0,122,103,0,37,269
855,7,0,0,0,103,1,38,149
856,6,2,0,0,103,1,37,149
857,7,0,0,0,103,1,37,148
858,7,0,0,0,104,39,38,188
859,7,0,0,0,104,38,38,187
860,6,1,0,0,104,37,37,185
861,7,0,0,0,103,36,38,184
862,7,0,0,0,104,38,38,187
863,7,0,0,0,103,38,38,186
864,7,0,0,0,103,37,38,185
865,6,0,0,0,104,37,38,185
866,7,0,0,0,104,37,38,186
867,7,0,0,0,104,38,38,187
868,7,0,0,0,104,36,38,185
869,7,0,0,0,104,37,38,186
870,7,0,0,1,103,38,38,187
871,7,0,0,0,104,37,38,186
872,7,0,0,0,103,37,37,184
873,7,1,0,0,103,38,38,187
874,7,1,0,0,103,36,37,184
875,7,0,0,0,111,1217,38,1373
876,6,0,0,0,114,1624,37,1781
877,7,1,0,0,113,1705,38,1864
878,7,0,0,1,115,1731,38,1892
879,6,0,0,1,115,1757,38,1917
880,6,1,0,1,114,1735,38,1895
881,7,0,0,0,114,1745,38,1904
882,7,0,0,0,114,1753,37,1911
883,7,0,0,0,114,1760,38,1919
884,7,0,0,0,115,1770,38,1930
885,7,0,0,0,115,1776,37,1935
886,7,0,0,0,114,1778,37,1936
887,7,1,0,141,114,1783,38,2084
888,7,0,0,130,114,1782,38,2071
889,7,1,0,128,114,1790,38,2078
890,7,0,0,126,114,1791,38,2076
891,7,0,0,125,114,1790,38,2074
892,7,0,0,124,114,1795,38,2078
893,7,0,0,123,114,1798,38,2080
894,326,1,0,122,113,1799,38,2399
895,325,0,0,122,114,1799,38,2398
896,325,0,0,0,113,1801,37,2276
897,325,0,0,0,113,1800,38,2276
898,328,1,0,10,113,1799,38,2289
899,328,0,0,10,115,1801,37,2291
900,329,0,0,0,112,1802,37,2280
901,327,0,0,0,114,1802,38,2281
902,327,0,0,0,113,1801,38,2279
903,329,1,0,0,113,1805,38,2286
904,330,0,0,0,114,1807,38,2289
905,331,0,0,0,114,1809,38,2292
906,333,0,0,0,107,1,37,478
907,331,0,0,0,105,0,37,473
908,332,0,0,0,103,1,38,474
909,330,0,0,0,103,1,37,471
910,330,0,0,0,104,1,38,473
911,330,1,0,0,103,0,38,472
912,329,1,0,0,103,0,38,471
913,329,0,0,0,104,1,37,471
914,330,0,0,0,103,1,38,472
915,329,1,0,0,103,1,37,471
916,328,0,0,0,103,0,38,469
917,326,0,0,0,104,1,37,468
918,328,0,0,0,103,1,37,469
919,327,0,0,0,104,0,37,468
920,326,0,0,0,103,1,37,467
921,328,0,0,0,103,1,38,470
922,328,0,0,0,103,39,37,507
923,328,0,0,0,103,37,38,506
924,331,0,0,145,103,37,37,653
925,330,0,0,131,104,37,38,640
926,332,0,0,127,103,37,37,636
927,331,0,0,126,103,36,38,634
928,330,0,0,125,104,37,39,635
929,330,1,0,124,103,36,38,632
930,330,0,0,123,104,36,38,631
931,330,0,0,122,103,36,38,629
932,329,0,0,122,103,35,38,627
933,329,1,0,0,105,37,37,509
934,328,1,0,0,103,35,37,504
935,328,0,0,0,104,36,38,506
936,329,0,0,0,103,35,38,505
937,330,1,0,0,102,36,38,507
938,330,0,0,0,103,37,37,507
939,329,0,0,0,104,37,37,507
940,329,0,0,0,103,36,38,506
941,328,1,0,0,111,1501,37,1978
942,330,0,0,0,111,1682,37,2160
943,436,1,0,0,113,1712,37,2299
944,436,1,0,0,113,1735,38,2323
945,424,0,0,0,113,1746,37,2320
946,415,0,0,0,112,1759,37,2323
947,426,0,0,0,113,1770,37,2346
948,414,0,0,0,114,1775,37,2340
949,419,1,0,0,113,1785,37,2355
950,435,0,0,0,113,1785,38,2371
951,432,1,0,0,113,1794,37,2377
952,418,0,0,0,113,1793,37,2361
953,247,0,0,1,112,1794,38,2192
954,7,0,0,0,113,1795,38,1953
955,7,0,0,0,113,1800,37,1957
956,6,1,0,1,112,1803,38,1961
957,6,0,0,1,112,1805,37,1961
958,7,0,0,1,113,1808,37,1966
959,7,0,0,10,112,1808,38,1975
960,6,0,0,8,114,1809,37,1974
961,6,0,0,10,113,1814,37,1980
962,7,1,0,7,113,1813,38,1979
963,7,0,0,8,113,1811,37,1976
964,6,0,0,146,114,1814,37,2117
965,7,0,0,139,106,1,37,290
966,7,0,0,138,104,1,38,288
967,7,0,0,136,105,1,37,286
968,7,0,0,136,104,0,38,285
969,6,1,0,135,104,1,37,284
970,6,0,0,134,104,1,37,282
971,6,0,0,133,103,1,37,280
972,7,0,0,132,103,1,37,280
973,6,0,0,132,103,1,37,279
974,7,0,0,131,103,1,37,279
975,7,0,0,130,103,0,38,278
976,6,1,0,131,103,1,38,280
977,6,0,0,130,103,1,38,278
978,6,0,0,129,103,1,37,276
979,6,1,0,129,103,1,38,278
980,7,0,0,129,104,1,38,279
981,6,0,0,7,103,0,37,153
982,7,0,0,7,104,37,38,193
983,7,0,0,7,103,37,38,192
984,6,1,0,7,103,37,37,191
985,7,0,0,7,103,37,37,191
986,449,0,0,6,104,37,38,634
987,401,0,0,6,104,36,37,584
988,331,1,0,6,103,37,38,516
989,7,0,0,7,103,37,38,192
990,7,0,0,152,103,36,38,336
991,6,1,0,144,103,37,37,328
992,7,1,0,138,103,36,38,323
993,7,0,0,137,103,37,37,321
994,6,0,0,135,103,36,38,318
995,7,0,0,134,104,37,38,320
996,7,1,0,135,104,36,38,321
997,7,1,0,130,103,36,37,314
998,7,0,0,127,103,38,37,312
999,7,0,0,126,103,36,37,309
1000,7,1,0,124,103,37,37,309
1001,6,0,0,124,103,36,38,307
1002,7,1,0,123,104,36,37,308
1003,7,0,0,0,103,37,38,185
1004,7,1,0,0,103,36,37,184
1005,6,1,0,0,104,36,37,184
1006,7,0,0,0,103,36,37,183
1007,7,1,0,0,104,36,37,185
1008,7,0,0,0,103,36,38,184
1009,6,0,0,0,103,36,38,183
1010,6,0,0,0,104,36,38,184
1011,6,0,0,0,103,37,38,184
1012,6,1,0,0,103,36,37,183
1013,7,1,0,0,111,1389,38,1546
1014,6,1,0,0,111,1621,38,1777
1015,7,1,0,0,111,1728,37,1884
1016,7,0,0,0,111,1755,37,1910
1017,6,0,0,0,114,1774,38,1932
1018,7,0,0,0,112,1787,37,1943
1019,7,2,0,0,113,1790,38,1950
1020,7,0,0,0,113,1766,38,1924
1021,7,0,0,0,113,1775,38,1933
1022,6,1,0,0,113,1777,37,1934
1023,7,0,0,0,112,1779,38,1936
1024,6,0,0,0,112,1782,38,1938
1025,7,0,0,1,113,1792,38,1951
1026,7,0,0,0,112,1792,38,1949
1027,7,0,0,1,112,1800,37,1957
1028,7,0,0,0,112,1798,37,1954
1029,7,0,0,0,113,1805,38,1963
1030,6,0,0,0,113,1801,38,1958
1031,6,0,0,0,113,1803,37,1959
1032,6,0,0,0,113,1806,38,1963
1033,7,0,0,144,113,1809,37,2110
1034,7,0,0,133,114,1806,38,2098
1035,7,1,0,126,114,1810,38,2096
1036,6,0,0,126,113,1810,38,2093
1037,7,1,0,125,114,1810,37,2094
1038,6,0,0,124,104,0,38,272
1039,7,0,0,124,103,1,38,273
1040,7,1,0,124,103,1,38,274
1041,7,0,0,123,103,1,37,271
1042,7,0,0,0,103,0,38,148
1043,7,0,0,0,103,1,38,149
1044,7,0,0,0,103,1,38,149
1045,7,0,0,0,103,0,38,148
1046,7,1,0,0,102,1,39,150
1047,6,0,0,0,103,1,38,148
1048,7,0,0,0,104,0,38,149
1049,6,0,0,0,103,0,38,147
1050,6,1,0,0,103,1,38,149
1051,7,0,0,0,102,1,38,148
1052,7,0,0,0,103,1,37,148
1053,7,1,0,0,103,1,38,150
1054,7,0,0,0,103,1,37,148
1055,6,0,0,0,103,37,38,184
1056,7,0,0,10,103,36,38,194
1057,7,0,0,10,103,37,38,195
1058,7,1,0,0,103,36,37,184
1059,6,0,0,0,104,36,37,183
1060,7,0,0,0,104,36,37,184
1061,7,1,0,0,103,36,37,184
1062,6,0,0,0,103,36,37,182
1063,7,0,0,0,103,36,37,183
1064,7,0,0,0,104,36,37,184
1065,7,0,0,0,103,35,38,183
1066,6,0,0,0,103,36,38,183
1067,6,1,0,0,103,36,38,184
1068,7,0,0,0,103,35,39,184
1069,7,0,0,147,102,36,37,329
1070,7,0,0,135,104,37,37,320
1071,7,1,0,127,103,35,38,311
1072,7,0,0,126,103,35,37,308
1073,7,1,0,125,103,36,38,310
1074,7,0,0,125,103,35,38,308
1075,6,0,0,124,111,1239,38,1518
1076,7,0,0,123,111,1590,37,1868
1077,7,0,0,123,111,1718,37,1996
1078,7,1,0,0,111,1750,38,1907
1079,7,0,0,0,110,1744,38,1899
1080,6,1,0,0,112,1750,38,1907
1081,7,1,0,0,111,1753,37,1909
1082,6,1,0,0,113,1766,37,1923
1083,7,0,0,1,112,1773,37,1930
1084,7,1,0,0,112,1778,37,1935
1085,6,0,0,0,114,1791,38,1949
1086,6,0,0,0,112,1789,38,1945
1087,7,1,0,0,112,1792,37,1949
1088,7,0,0,0,113,1792,38,1950
1089,7,0,0,0,114,1809,37,1967
1090,6,0,0,0,113,1803,37,1959
1091,6,1,0,0,113,1802,37,1959
1092,7,1,0,0,113,1790,38,1949
1093,6,0,0,0,114,1807,38,1965
1094,7,0,0,1,112,1811,38,1969
1095,7,0,0,0,113,1814,38,1972
1096,6,1,0,0,112,1819,38,1976
1097,7,0,0,0,103,1,38,149
1098,6,0,0,0,103,1,38,148
1099,7,0,0,0,102,0,39,148
1100,7,1,0,0,103,1,37,149
1101,7,0,0,0,103,1,38,149
1102,6,0,0,0,102,1,38,147
1103,6,0,0,0,103,1,37,147
1104,6,0,0,0,103,1,38,148
1105,7,0,0,0,103,1,39,150
1106,7,0,0,0,103,2,38,150
1107,7,0,0,0,103,1,37,148
1108,7,0,0,0,103,1,37,148
1109,6,0,0,0,103,1,38,148
1110,7,0,0,1,103,1,38,150
1111,7,1,0,147,103,1,38,297
1112,7,0,0,135,103,1,38,284
1113,7,0,0,128,103,39,37,314
1114,7,0,0,127,103,38,38,313
1115,7,1,0,126,103,37,38,312
1116,6,0,0,125,104,38,38,311
1117,7,0,0,127,103,37,38,312
1118,7,0,0,126,103,37,37,310
1119,7,1,0,123,103,37,37,308
1120,6,0,0,0,103,38,38,185
1121,7,0,0,0,103,38,37,185
1122,7,0,0,0,104,36,37,184
1123,7,1,0,0,103,36,38,185
1124,7,0,0,0,103,37,37,184
1125,6,0,0,0,103,36,37,182
1126,7,0,0,0,103,37,38,185
1127,7,0,0,0,104,36,37,184
1128,7,1,0,0,103,36,37,184
1129,7,0,0,0,103,36,37,183
1130,6,0,0,0,103,37,38,184
1131,7,0,0,0,103,37,38,185
1132,6,0,0,0,102,36,37,181
1133,7,0,0,0,103,37,38,185
1134,7,0,0,0,103,36,38,184
1135,7,0,0,0,103,37,37,184
1136,6,0,0,0,104,37,38,185
1137,7,0,0,0,105,37,38,187
1138,6,1,0,0,103,38,37,185
1139,7,0,0,0,103,38,38,186
1140,7,0,0,0,105,37,38,187
1141,7,0,0,0,103,37,37,184
1142,6,0,0,0,104,36,38,184
1143,7,0,0,0,103,36,38,184
1144,7,0,0,7,103,37,37,191
1145,6,1,0,7,103,35,38,190
1146,6,0,0,7,104,37,38,192
1147,7,0,0,7,105,37,38,194
1148,7,1,0,145,104,38,38,333
1149,6,0,0,138,103,36,38,321
1150,7,1,0,136,104,38,38,324
1151,6,0,0,136,104,37,37,320
1152,7,0,0,135,104,37,38,321
1153,7,0,0,133,103,36,37,316
1154,6,0,0,132,104,36,38,316
1155,6,0,0,132,103,36,39,316
1156,7,0,0,130,103,37,38,315
1157,7,1,0,130,104,37,38,317
1158,7,1,0,130,103,36,37,314
1159,6,0,0,130,103,37,38,314
1160,6,0,0,129,104,37,38,314
1161,6,0,0,129,104,37,37,313
1162,6,0,0,128,104,36,38,312
1163,7,0,0,128,104,37,39,315
1164,7,0,0,7,103,36,38,191
1165,7,0,0,7,103,36,38,191
1166,7,0,0,7,104,37,38,193
1167,6,0,0,7,102,38,38,191
1168,7,0,0,7,104,37,38,193
1169,6,1,0,7,104,38,38,194
1170,7,0,0,7,103,37,39,193
1171,7,0,0,7,104,38,38,194
1172,7,0,0,7,104,37,38,193
1173,6,0,0,7,104,36,37,190
1174,6,0,0,154,103,37,37,337
1175,7,1,0,135,103,38,38,322
1176,7,1,0,132,104,37,38,319
1177,7,1,0,130,104,38,38,318
1178,7,0,0,129,104,36,37,313
1179,7,1,0,127,103,38,38,314
1180,6,1,0,127,103,37,38,312
1181,7,1,0,125,103,38,38,312
1182,7,0,0,124,103,37,38,309
1183,7,1,0,123,103,36,37,307
1184,7,1,0,122,104,36,37,307
1185,6,0,0,0,104,37,38,185
1186,7,0,0,0,104,36,37,184
1187,7,1,0,0,104,36,37,185
1188,6,1,0,0,104,38,38,187
1189,7,0,0,0,104,37,38,186
1190,6,1,0,0,103,36,38,184
1191,7,1,0,0,104,36,38,186
1192,6,0,0,0,103,38,38,185
1193,7,1,0,0,103,36,38,185
1194,7,0,0,1,104,38,37,187
1195,7,0,0,0,103,36,38,184
1196,7,1,0,0,104,37,38,187
1197,7,0,0,0,103,37,37,184
1198,7,0,0,0,104,36,38,185
1199,6,1,0,0,103,37,38,185
1200,7,1,0,1,104,37,38,188
1201,7,1,0,1,104,37,38,188
1202,7,0,0,1,105,38,38,189
1203,7,0,0,0,103,37,38,185
1204,7,0,0,80,103,36,37,263
1205,6,0,0,1,104,36,37,184
1206,6,1,0,0,104,38,38,187
1207,6,0,0,0,103,37,37,183
1208,7,0,0,0,104,36,37,184
1209,7,0,0,0,103,37,38,185
1210,7,0,0,0,104,37,37,185
1211,7,0,0,0,103,38,38,186
1212,7,0,0,0,103,38,38,186
1213,7,0,0,0,103,37,38,185
1214,7,0,0,0,104,37,37,185
1215,7,0,0,0,104,37,39,187
1216,7,0,0,141,104,37,38,327
1217,7,0,0,139,103,37,38,324
1218,7,0,0,129,104,36,38,314
1219,7,0,0,130,104,36,37,314
1220,7,1,0,127,104,37,37,313
1221,7,0,0,126,104,37,38,312
1222,7,0,0,125,103,36,37,308
1223,7,1,0,126,104,38,38,314
1224,7,0,0,123,104,37,37,308
1225,7,0,0,123,104,37,38,309
1226,7,0,0,0,104,36,38,185
1227,7,0,0,10,104,37,38,196
1228,6,0,0,7,103,37,37,190
1229,7,0,0,7,104,37,38,193
1230,7,0,0,7,104,38,38,194
1231,7,0,0,7,104,37,38,193
1232,6,0,0,7,104,37,37,191
1233,7,0,0,7,104,36,38,192
1234,7,0,0,7,104,37,38,193
1235,7,0,0,7,103,36,37,190
1236,6,0,0,7,104,37,37,191
1237,6,1,0,150,104,37,37,335
1238,7,0,0,138,103,37,37,322
1239,7,0,0,136,103,36,38,320
1240,7,0,0,135,103,37,38,320
1241,6,0,0,134,104,36,37,317
1242,6,0,0,133,103,38,38,318
1243,6,0,0,133,103,36,37,315
1244,7,1,0,133,103,36,37,317
1245,7,0,0,131,103,37,37,315
1246,6,0,0,131,103,36,37,313
1247,7,0,0,130,103,37,38,315
1248,6,1,0,130,103,37,38,315
1249,7,1,0,129,104,36,37,314
1250,7,1,0,129,104,36,38,315
1251,6,1,0,128,103,36,38,312
1252,7,1,0,128,104,37,38,315
1253,7,1,0,128,104,36,37,313
1254,7,0,0,7,103,36,38,191
1255,7,1,0,7,103,35,38,191
1256,7,0,0,7,104,37,38,193
1257,7,1,0,10,111,1220,38,1387
1258,7,0,0,1,111,1573,38,1730
1259,6,0,0,0,110,1694,38,1848
1260,7,0,0,0,111,1744,37,1899
1261,7,0,0,1,111,1758,37,1914
1262,7,0,0,0,110,1774,38,1929
1263,6,1,0,0,111,1779,38,1935
1264,7,0,0,150,111,1801,38,2107
1265,7,0,0,137,113,1765,38,2060
1266,7,0,0,130,113,1774,38,2062
1267,7,1,0,127,111,1775,38,2059
1268,6,0,0,127,112,1781,38,2064
1269,7,0,0,127,112,1797,37,2080
1270,7,0,0,124,113,1785,37,2066
1271,7,0,0,123,113,1792,37,2072
1272,6,0,0,122,113,1797,37,2075
1273,7,0,0,0,112,1797,38,1954
1274,7,0,0,0,113,1800,38,1958
1275,6,0,0,1,111,1798,38,1954
1276,6,0,0,0,113,1800,38,1957
1277,7,0,0,0,113,1803,38,1961
1278,7,1,0,0,112,1801,38,1959
1279,7,0,0,0,103,1,38,149
1280,7,0,0,0,103,1,37,148
1281,7,1,0,0,104,1,38,151
1282,7,0,0,0,103,1,37,148
1283,332,0,0,0,103,1,38,474
1284,426,0,0,0,103,0,38,567
1285,426,1,0,0,103,0,37,567
1286,420,0,0,0,103,1,38,562
1287,430,0,0,0,104,1,38,573
1288,438,0,0,0,103,1,38,580
1289,333,0,0,0,104,1,39,477
1290,334,0,0,0,104,1,38,477
1291,333,0,0,0,103,0,39,475
1292,331,1,0,0,103,1,38,474
1293,331,1,0,0,103,1,38,474
1294,332,0,0,0,104,0,38,474
1295,333,0,0,0,103,1,38,475
1296,331,0,0,0,105,1,38,475
1297,333,0,0,0,103,1,37,474
1298,332,1,0,0,104,38,39,514
1299,333,0,0,0,103,37,38,511
1300,433,0,0,0,103,37,38,611
1301,429,0,0,0,103,38,38,608
1302,332,2,0,0,104,37,38,513
1303,337,0,0,0,104,36,38,515
1304,335,0,0,0,103,38,38,514
1305,336,0,0,143,104,36,38,657
1306,336,0,0,131,104,36,38,645
1307,338,0,0,127,104,38,38,645
1308,337,0,0,127,103,37,38,642
1309,432,0,0,126,104,37,38,737
1310,439,1,0,124,104,37,38,743
1311,447,0,0,126,104,38,38,753
1312,440,0,0,124,104,37,38,743
1313,437,0,0,124,104,38,38,741
1314,437,0,0,0,105,37,38,617
1315,435,1,0,0,104,37,38,615
1316,431,0,0,0,104,38,38,611
1317,431,1,0,10,104,37,38,621
1318,436,0,0,7,104,38,39,624
1319,431,0,0,0,104,36,38,609
1320,430,0,0,0,104,37,38,609
1321,410,0,0,1,104,37,38,590
1322,407,0,0,0,104,37,38,586
1323,404,0,0,0,103,36,38,581
1324,408,1,0,0,103,38,39,589
1325,407,0,0,0,104,36,38,585
1326,407,0,0,0,103,38,38,586
1327,408,0,0,0,104,38,38,588
1328,408,0,0,0,104,38,38,588
1329,410,1,0,0,104,37,38,590
1330,409,0,0,0,103,37,38,587
1331,410,0,0,0,103,37,38,588
1332,411,1,0,0,104,38,38,592
1333,408,0,0,0,103,37,38,586
1334,408,0,0,0,103,38,37,586
1335,81,1,0,0,104,37,38,261
1336,408,0,0,0,104,37,38,587
1337,404,0,0,0,103,37,38,582
1338,406,0,0,0,104,37,38,585
1339,408,0,0,0,104,37,38,587
1340,406,0,0,0,104,37,37,584
1341,404,0,0,147,103,37,38,729
1342,403,0,0,135,103,35,37,713
1343,405,1,0,129,103,36,38,712
1344,406,0,0,127,103,36,37,709
1345,403,0,0,125,103,36,38,705
1346,401,0,0,124,104,37,37,703
1347,403,0,0,123,103,37,38,704
1348,403,0,0,123,103,35,38,702
1349,404,0,0,122,104,37,37,704
1350,409,0,0,0,104,36,38,587
1351,408,0,0,0,104,37,38,587
1352,408,1,0,0,104,38,38,589
1353,406,1,0,0,104,37,37,585
1354,413,0,0,0,104,37,38,592
1355,414,0,0,0,104,37,37,592
1356,414,1,0,1,105,37,38,596
1357,420,0,0,1,104,36,38,599
1358,411,0,0,0,104,36,38,589
1359,413,0,0,0,105,36,38,592
1360,414,0,0,0,105,37,39,595
1361,416,0,0,1,103,37,38,595
1362,410,1,0,0,104,37,38,590
1363,410,1,0,1,104,36,38,590
1364,474,1,0,0,105,37,37,654
1365,338,0,0,0,104,37,38,517
1366,11,1,0,0,104,37,38,191
1367,339,0,0,0,104,37,38,518
1368,339,0,0,0,104,37,38,518
1369,337,1,0,0,103,36,37,514
1370,338,0,0,0,104,36,38,516
1371,340,0,0,0,104,36,38,518
1372,336,1,0,0,103,38,37,515
1373,335,1,0,0,103,38,37,514
1374,338,0,0,0,104,37,38,517
1375,451,0,0,0,103,36,39,629
1376,442,0,0,0,104,37,38,621
1377,432,1,0,0,104,36,38,611
1378,445,0,0,7,104,37,37,630
1379,440,1,0,0,104,37,38,620
1380,437,0,0,0,103,37,38,615
1381,436,1,0,0,104,36,37,614
1382,431,1,0,143,104,37,38,754
1383,443,1,0,132,104,37,38,755
1384,434,0,0,128,104,38,37,741
1385,436,0,0,128,103,37,38,742
1386,435,0,0,125,104,37,38,739
1387,433,0,0,125,104,37,37,736
1388,440,0,0,123,104,37,38,742
1389,353,0,0,123,103,36,37,652
1390,338,1,0,122,104,37,38,640
1391,338,0,0,0,104,37,38,517
1392,336,0,0,0,104,36,38,514
1393,335,1,0,0,104,37,37,514
1394,335,0,0,0,104,38,37,514
1395,337,1,0,0,103,37,38,516
1396,337,0,0,0,104,35,39,515
1397,338,0,0,0,105,37,38,518
1398,333,0,0,0,103,36,38,510
1399,331,1,0,0,104,36,38,510
1400,331,1,0,0,104,36,38,510
1401,329,0,0,0,103,36,37,505
1402,333,0,0,0,103,37,38,511
1403,336,0,0,7,104,37,38,522
1404,334,0,0,7,103,36,38,518
1405,335,1,0,7,103,36,38,520
1406,334,0,0,7,103,36,38,518
1407,335,0,0,7,104,36,38,520
1408,335,0,0,7,104,36,38,520
1409,334,0,0,7,104,37,38,520
1410,334,0,0,7,104,36,38,519
1411,334,0,0,148,104,36,38,660
1412,334,2,0,138,103,37,37,651
1413,334,1,0,138,102,36,38,649
1414,335,0,0,134,104,37,38,648
1415,335,1,0,134,104,36,38,648
1416,334,0,0,133,104,36,39,646
1417,8,1,0,132,103,36,38,318
1418,8,1,0,132,104,36,38,319
1419,7,0,0,132,104,37,38,318
1420,7,0,0,131,104,37,38,317
1421,7,0,0,131,103,37,39,317
1422,7,2,0,130,104,37,38,318
1423,7,0,0,130,104,36,38,315
1424,7,0,0,130,104,36,38,315
1425,7,1,0,129,104,36,38,315
1426,7,1,0,129,104,37,38,316
1427,7,0,0,7,103,38,38,193
1428,7,0,0,7,104,37,37,192
1429,7,0,0,7,103,38,38,193
1430,7,0,0,7,103,37,55,209
1431,7,1,0,7,104,37,55,211
1432,7,0,0,7,104,36,55,209
1433,7,0,0,0,104,36,211,358
1434,7,0,0,0,104,38,238,387
1435,7,0,0,0,103,37,277,424
1436,7,0,0,0,103,36,280,426
1437,7,0,0,146,104,37,256,550
1438,7,0,0,133,104,37,234,515
1439,7,0,0,130,103,37,231,508
1440,7,0,0,128,104,36,297,572
1441,7,0,0,127,103,36,297,570
1442,7,0,0,126,103,36,289,561
1443,7,0,0,125,104,37,286,559
1444,7,0,0,123,103,35,285,553
1445,7,0,0,122,104,37,288,558
1446,7,1,0,0,103,36,278,425
1447,7,0,0,0,103,36,274,420
1448,7,0,0,0,104,37,281,429
1449,7,1,0,0,104,38,265,415
1450,7,0,0,0,103,37,298,445
1451,7,0,0,0,104,36,260,407
1452,7,0,0,0,103,36,254,400
1453,7,0,0,0,103,36,241,387
1454,7,0,0,0,103,36,253,399
1455,7,0,0,0,103,36,238,384
1456,7,0,0,0,104,37,239,387
1457,7,0,0,0,104,36,249,396
1458,7,1,0,0,103,35,227,373
1459,7,0,0,1,104,36,234,382
1460,7,0,0,0,103,36,232,378
1461,7,1,0,0,104,37,254,403
1462,7,1,0,0,111,1546,266,1931
1463,7,0,0,0,110,1665,289,2071
1464,7,1,0,0,111,1735,266,2120
1465,7,0,0,0,111,1728,283,2129
1466,7,0,0,1,111,1749,248,2116
1467,7,0,0,0,111,1754,239,2111
1468,7,0,0,0,112,1770,194,2083
1469,7,0,0,0,112,1766,219,2104
1470,7,0,0,0,113,1781,228,2129
1471,7,0,0,0,111,1782,241,2141
1472,7,1,0,0,112,1785,240,2145
1473,7,0,0,0,111,1791,262,2171
1474,7,1,0,0,113,1792,254,2167
1475,7,1,0,0,112,1794,255,2169
1476,7,0,0,0,113,1798,274,2192
1477,7,0,0,0,112,1800,281,2200
1478,7,0,0,143,112,1808,49,2119
1479,327,0,0,138,112,1806,48,2431
1480,329,1,0,128,111,1806,48,2423
1481,327,0,0,127,112,1811,48,2425
1482,37,0,0,128,113,1818,47,2143
1483,7,1,0,126,112,1814,48,2108
1484,7,0,0,124,112,1813,48,2104
1485,7,0,0,123,112,1817,48,2107
1486,7,0,0,123,104,1,49,284
1487,7,0,0,0,103,1,48,159
1488,7,1,0,0,104,1,48,161
1489,7,0,0,0,103,1,48,159
1490,7,0,0,0,103,1,49,160
1491,7,1,0,0,103,1,48,160
1492,7,0,0,0,103,1,48,159
1493,7,0,0,10,103,0,48,168
1494,7,0,0,0,103,1,49,160
1495,7,0,0,0,103,1,48,159
1496,7,1,0,0,104,1,48,161
1497,7,0,0,1,103,1,48,160
1498,7,0,0,0,103,1,48,159
1499,7,0,0,0,104,1,48,160
1500,7,0,0,0,103,1,48,159
1501,7,0,0,0,103,1,48,159
1502,7,0,0,0,104,1,48,160
1503,7,0,0,0,103,1,47,158
1504,7,0,0,0,103,37,48,195
1505,7,0,0,0,104,37,48,196
1506,7,0,0,1,102,36,48,194
1507,7,0,0,0,102,36,47,192
1508,7,0,0,0,103,36,48,194
1509,7,1,0,0,103,36,48,195
1510,7,1,0,0,103,38,48,197
1511,7,0,0,0,104,36,47,194
1512,7,1,0,0,103,37,49,197
1513,7,0,0,149,104,37,47,344
1514,7,1,0,136,103,37,48,332
1515,7,0,0,131,103,36,38,315
1516,7,1,0,128,104,36,37,313
1517,7,0,0,128,104,37,38,314
1518,7,0,0,126,103,36,37,309
1519,7,1,0,125,104,37,38,312
1520,7,0,0,124,103,36,37,307
1521,7,0,0,123,103,36,37,306
1522,7,0,0,7,103,37,38,192
1523,7,0,0,7,104,36,37,191
1524,7,1,0,7,104,37,38,194
1525,7,0,0,7,103,37,37,191
1526,7,0,0,7,104,36,38,192
1527,7,0,0,7,104,38,38,194
1528,7,0,0,7,103,37,37,191
1529,7,0,0,7,104,37,37,192
1530,7,0,0,7,102,37,38,191
1531,7,0,0,7,103,36,38,191
1532,7,1,0,153,103,37,37,338
1533,7,0,0,144,104,37,38,330
1534,7,1,0,138,103,36,38,323
1535,7,0,0,136,105,35,38,321
1536,7,0,0,135,104,36,38,320
1537,7,0,0,134,104,36,39,320
1538,7,0,0,134,104,36,38,319
1539,7,1,0,133,104,36,37,318
1540,7,0,0,132,104,36,38,317
1541,7,0,0,133,103,38,38,319
1542,7,0,0,131,104,36,38,316
1543,7,0,0,131,104,36,38,316
1544,7,1,7,130,103,36,38,322
1545,7,0,7,130,103,36,37,320
1546,8,1,777,128,103,37,37,1091
1547,8,0,759,129,104,36,37,1073
1548,7,0,773,128,104,37,38,1087
1549,7,0,759,6,104,37,38,951
1550,7,0,13,7,103,37,38,205
1551,334,0,13,7,104,38,38,534
1552,333,0,7,7,103,36,37,523
1553,334,0,7,7,103,36,38,525
1554,333,0,786,0,103,36,37,1295
1555,333,1,786,0,104,36,37,1297
1556,331,0,780,0,104,36,37,1288
1557,331,1,769,0,103,36,37,1277
1558,332,6,24,0,104,36,38,540
1559,332,6,13,0,103,35,38,527
1560,329,4730,6,147,103,36,37,5388
1561,331,4616,6,132,104,35,38,5262
1562,330,4626,764,129,103,37,38,6027
1563,330,4615,773,127,103,36,37,6021
1564,330,4612,771,125,104,35,37,6014
1565,331,4628,771,123,103,36,37,6029
1566,333,4637,25,124,104,36,38,5297
1567,331,4605,13,124,103,36,38,5250
1568,333,4586,7,122,103,36,38,5225
1569,7,4608,7,1,103,37,37,4800
1570,334,4589,145,0,104,36,38,5246
1571,334,4586,135,0,103,36,38,5232
1572,334,4609,137,0,103,36,37,5256
1573,333,4585,145,0,103,36,38,5240
1574,334,4591,16,0,104,36,37,5118
1575,335,4557,14,0,104,38,37,5085
1576,334,4575,7,0,104,36,37,5093
1577,334,4583,6,0,104,38,37,5102
1578,334,4567,144,0,104,36,37,5222
1579,334,4564,152,0,104,37,37,5228
1580,332,4588,136,0,104,37,38,5235
1581,331,4569,144,0,103,36,37,5220
1582,329,4565,13,0,102,37,38,5084
1583,327,4567,13,0,103,36,37,5083
1584,326,4552,6,0,104,37,37,5062
1585,328,4561,7,0,103,38,37,5074
1586,327,4541,155,0,103,36,37,5199
1587,330,4557,154,0,103,37,38,5219
1588,329,4553,761,0,103,37,37,5820
1589,329,4558,762,0,103,36,37,5825
1590,329,4544,759,0,103,36,37,5808
1591,328,4532,758,0,104,36,38,5796
1592,328,4518,766,0,103,36,37,5788
1593,331,250,775,0,104,36,37,1533
1594,330,245,773,0,103,37,37,1525
1595,329,4605,770,0,103,36,37,5880
1596,333,247,780,0,104,37,37,1538
1597,332,246,777,0,104,36,37,1532
1598,333,243,776,0,104,36,38,1530
1599,331,247,774,0,104,36,38,1530
1600,330,257,770,138,104,36,37,1672
1601,329,254,768,139,104,36,38,1668
1602,7,258,768,127,104,37,38,1339
1603,7,260,764,126,103,36,37,1333
1604,7,252,764,125,104,36,37,1325
1605,7,259,3,125,103,37,37,571
1606,7,0,14,124,103,36,37,321
1607,7,1,3,126,104,36,37,314
1608,7,1,7,122,104,35,37,313
1609,7,0,130,0,103,36,37,313
1610,7,0,127,0,103,36,37,310
1611,6,0,122,0,103,35,37,303
1612,7,1,119,0,103,36,37,303
1613,7,0,2,7,103,36,37,192
1614,7,1,14,0,103,36,37,198
1615,7,1,3,0,104,36,37,188
1616,7,1,7,1,103,36,37,192
1617,7,1,148,0,103,37,37,333
1618,7,0,127,0,104,37,37,312
1619,7,0,750,0,104,38,37,936
1620,7,0,745,0,103,36,37,928
1621,7,0,740,0,104,35,37,923
1622,7,0,740,0,103,36,37,923
1623,7,0,740,0,103,36,37,923
1624,7,1,738,0,104,36,37,923
1625,7,0,740,0,104,36,37,924
1626,7,0,733,0,103,35,37,915
1627,7,0,732,0,104,35,37,915
1628,7,0,734,0,104,36,37,918
1629,7,1,729,0,104,35,37,913
1630,7,0,739,0,104,36,36,922
1631,7,0,734,0,103,36,37,917
1632,327,0,729,0,103,36,36,1231
1633,325,0,727,0,104,35,37,1228
1634,325,0,728,0,103,37,37,1230
1635,323,0,727,0,104,35,37,1226
1636,323,0,723,0,103,35,37,1221
1637,324,0,729,0,103,35,37,1228
1638,324,1,726,144,104,36,36,1371
1639,323,0,726,132,103,36,37,1357
1640,325,1,729,127,104,37,37,1360
1641,325,0,730,203,103,35,36,1432
1642,323,0,723,125,104,35,36,1346
1643,324,0,727,123,103,36,37,1350
1644,324,1,727,122,103,34,37,1348
1645,324,0,726,121,103,35,36,1345
1646,325,0,731,122,103,36,37,1354
1647,325,0,732,0,104,36,37,1234
1648,324,1,727,0,103,34,37,1226
1649,325,0,725,0,103,36,37,1226
1650,325,1,731,0,104,34,37,1232
1651,325,0,24,0,103,36,37,525
1652,409,0,13,0,102,36,37,597
1653,422,0,2,0,103,36,37,600
1654,416,0,2,0,103,36,37,594
1655,425,0,2,0,104,36,37,604
1656,424,0,2,0,104,35,37,602
1657,434,1,2,0,103,37,37,614
1658,421,0,2,0,104,36,37,600
1659,430,0,2,0,103,36,37,608
1660,430,1,2,0,103,36,36,608
1661,430,0,2,0,103,36,37,608
1662,427,1,2,0,103,36,37,606
1663,433,0,2,0,103,36,37,611
1664,423,0,2,0,103,36,37,601
1665,426,0,2,0,104,36,37,605
1666,435,0,2,0,103,35,37,612
1667,435,0,2,0,104,36,37,614
1668,439,1,2,0,104,37,37,620
1669,430,0,2,0,103,35,37,607
1670,430,0,2,0,103,37,37,609
1671,434,1,2,0,103,36,37,613
1672,435,1,2,0,103,36,37,614
1673,430,0,2,0,103,36,37,608
1674,431,0,2,10,103,36,37,619
1675,430,0,2,10,103,36,37,618
1676,433,0,2,7,103,35,37,617
1677,438,0,13,6,103,36,37,633
1678,436,1,14,149,104,37,37,778
1679,436,0,2,139,103,37,37,754
1680,436,0,2,135,104,37,37,751
1681,436,0,2,134,103,36,37,748
1682,436,1,2,133,105,35,36,748
1683,434,0,2,132,103,36,37,744
1684,436,1,2,132,103,35,37,746
1685,436,0,2,131,103,37,37,746
1686,432,0,2,131,104,35,38,742
1687,425,0,2,130,104,36,37,734
1688,435,0,2,130,104,37,38,746
1689,427,0,13,129,103,36,37,745
1690,426,0,13,129,103,37,38,746
1691,436,1,0,128,103,37,38,743
1692,435,1,0,128,104,36,37,741
1693,424,0,0,128,103,37,38,730
1694,423,0,0,6,103,36,38,606
1695,421,0,0,7,103,38,38,607
1696,425,0,0,7,103,36,38,609
1697,436,0,0,6,104,38,38,622
1698,434,0,0,7,103,36,37,617
1699,440,0,0,7,104,37,38,626
1700,434,0,0,6,103,37,37,617
1701,436,1,0,7,103,36,37,620
1702,438,0,0,6,104,37,38,623
1703,436,0,0,149,102,37,38,762
1704,424,0,0,143,103,37,105,812
1705,424,0,0,134,104,36,219,917
1706,425,0,0,132,103,38,213,911
1707,424,0,0,130,104,36,226,920
1708,425,1,0,130,103,36,233,928
1709,400,1,0,127,103,37,236,904
1710,401,0,0,126,103,36,246,912
1711,401,1,0,124,103,37,260,926
1712,401,1,0,123,103,37,229,894
1713,401,0,0,122,102,36,237,898
1714,399,0,0,0,104,36,221,760
1715,400,1,0,0,103,36,237,777
1716,396,0,0,0,103,36,243,778
1717,397,1,0,0,103,37,301,839
1718,395,0,0,0,111,1516,394,2416
1719,422,0,0,0,110,1643,256,2431
1720,348,0,0,0,110,1711,215,2384
1721,329,0,0,0,111,1754,221,2415
1722,329,1,0,0,111,1770,239,2450
1723,330,0,0,0,111,1757,242,2440
1724,330,1,0,0,111,1758,215,2415
1725,330,0,0,0,111,1768,311,2520
1726,332,1,0,0,111,1773,223,2440
1727,332,0,0,0,111,1784,236,2463
1728,331,0,0,0,111,1789,217,2448
1729,333,0,0,0,111,1794,216,2454
1730,332,0,0,0,111,1797,220,2460
1731,333,0,0,0,111,1801,225,2470
1732,334,0,0,0,111,1805,205,2455
1733,333,0,0,0,111,1805,251,2500
1734,334,0,0,0,111,1809,254,2508
1735,335,1,0,0,111,1808,242,2497
1736,334,0,0,0,111,1809,226,2480
1737,333,1,0,0,112,1811,253,2510
1738,334,0,0,0,111,1814,245,2504
1739,336,1,0,0,104,173,250,864
1740,337,0,0,0,104,1,235,677
1741,336,0,0,0,104,1,236,677
1742,334,0,0,0,103,1,305,743
1743,327,0,0,0,104,1,370,802
1744,329,0,0,0,103,1,257,690
1745,329,0,0,0,103,1,398,831
1746,330,0,0,145,104,1,290,870
1747,331,0,0,132,103,1,264,831
1748,331,0,0,127,103,1,308,870
1749,330,0,0,126,103,1,263,823
1750,332,0,0,125,104,1,242,804
1751,331,0,0,125,103,1,286,846
1752,331,1,0,124,104,1,240,801
1753,332,0,0,123,103,0,355,913
1754,333,0,0,123,104,1,292,853
1755,334,0,0,0,104,1,308,747
1756,333,0,0,0,103,38,262,736
1757,332,0,0,0,103,38,328,801
1758,332,0,0,0,103,38,250,723
1759,333,1,0,0,103,36,233,706
1760,335,1,0,0,103,36,246,721
1761,335,0,0,0,104,38,234,711
1762,335,0,0,0,104,38,239,716
1763,335,0,0,0,103,38,243,719
1764,336,0,0,7,103,38,240,724
1765,335,0,0,0,103,37,241,716
1766,336,0,0,0,104,37,230,707
1767,333,1,0,0,103,36,223,696
1768,334,0,0,0,104,37,297,772
1769,334,1,0,0,103,36,252,726
1770,335,1,0,0,104,36,243,719
1771,336,0,0,0,104,37,232,709
1772,335,0,0,0,104,37,231,707
1773,337,0,0,0,103,37,239,716
1774,338,0,0,0,104,37,229,708
1775,338,0,0,0,104,38,223,703
1776,337,0,0,0,105,36,245,723
1777,335,1,0,0,105,36,233,710
1778,335,0,0,0,104,37,381,857
1779,335,0,0,0,103,38,231,707
1780,335,0,0,0,104,37,249,725
1781,335,1,0,0,104,37,230,707
1782,336,1,0,0,104,36,247,724
1783,334,0,0,144,104,37,230,849
1784,335,0,0,132,104,37,235,843
1785,335,0,0,128,104,38,234,839
1786,335,0,0,127,104,37,236,839
1787,336,0,0,126,104,37,230,833
1788,336,1,0,127,104,38,260,866
1789,335,1,0,124,104,38,239,841
1790,334,0,0,123,104,36,265,862
1791,335,0,0,122,103,36,400,996
1792,335,1,0,0,103,37,260,736
1793,334,1,0,0,104,36,245,720
1794,335,1,0,0,105,37,231,709
1795,334,1,0,0,103,36,234,708
1796,334,0,0,0,104,38,233,709
1797,332,0,0,0,103,37,227,699
1798,332,0,0,0,104,36,224,696
1799,332,0,0,0,104,37,228,701
1800,334,0,0,0,103,37,251,725
1801,337,1,0,0,104,37,231,710
1802,338,0,0,0,104,38,245,725
1803,338,0,0,0,103,38,227,706
1804,338,1,0,0,105,37,255,736
1805,337,0,0,0,104,37,238,716
1806,337,0,0,0,104,38,323,802
1807,336,0,0,0,111,1521,232,2200
1808,337,0,0,0,112,1661,235,2345
1809,336,0,0,0,111,1728,232,2407
1810,337,0,0,0,111,1770,222,2440
1811,336,1,0,0,112,1747,245,2441
1812,337,0,0,0,111,1763,331,2542
1813,336,0,0,0,112,1768,221,2437
1814,337,0,0,0,111,1774,229,2451
1815,334,1,0,0,111,1781,206,2433
1816,336,0,0,0,111,1786,305,2538
1817,337,0,0,0,111,1798,37,2283
1818,336,5,0,0,111,1794,37,2283
1819,337,1,0,0,111,1805,38,2292
1820,337,0,0,0,111,1805,37,2290
1821,338,0,0,0,112,1806,38,2294
1822,335,1,0,0,111,1809,37,2293
1823,335,0,0,0,111,1811,37,2294
1824,355,0,0,0,111,1813,39,2318
1825,355,0,0,147,111,1810,38,2461
1826,354,1,0,132,111,1814,39,2451
1827,356,0,0,129,111,1815,38,2449
1828,359,0,0,128,112,1818,38,2455
1829,357,0,0,127,112,1815,38,2449
1830,357,0,0,126,105,1,38,627
1831,356,0,0,125,103,1,38,623
1832,356,0,0,123,104,1,38,622
1833,27,0,0,124,104,1,38,294
1834,27,1,0,0,104,1,37,170
1835,27,0,0,0,104,1,39,171
1836,27,2,0,0,103,1,39,172
1837,27,0,0,0,104,1,38,170
1838,27,0,0,0,104,1,39,171
1839,27,0,0,0,104,1,39,171
1840,27,0,0,0,104,1,39,171
1841,27,1,0,0,103,1,38,170
1842,27,0,0,0,103,1,38,169
1843,27,2,0,1,104,1,38,173
1844,27,0,0,0,104,1,38,170
1845,27,0,0,0,104,1,38,170
1846,27,1,0,0,104,39,39,210
1847,27,0,0,0,104,38,38,207
1848,27,0,0,0,105,39,38,209
1849,27,0,0,0,103,38,38,206
1850,27,0,0,0,103,37,38,205
1851,27,0,0,0,104,38,39,208
1852,27,1,0,0,104,38,38,208
1853,27,0,0,0,104,37,39,207
1854,27,1,0,1,104,37,39,209
1855,27,1,0,10,103,37,39,217
1856,27,0,0,7,105,37,38,214
1857,27,1,0,7,104,38,39,216
1858,27,0,0,7,103,38,39,214
1859,27,1,0,7,103,36,38,212
1860,27,0,0,7,103,38,39,214
1861,26,0,0,150,105,37,38,356
1862,27,0,0,140,103,37,39,346
1863,7,0,0,137,103,36,38,321
1864,7,0,0,135,103,37,38,320
1865,6,0,0,134,103,36,39,318
1866,7,1,0,133,104,37,39,321
1867,7,0,0,133,103,37,39,319
1868,7,0,0,132,103,37,38,317
1869,7,0,0,132,104,37,39,319
1870,7,0,0,132,104,38,38,319
1871,7,0,0,130,103,37,38,315
1872,7,0,0,130,105,36,39,317
1873,27,1,0,130,104,36,38,336
1874,7,0,0,130,111,1104,39,1391
1875,7,1,0,131,111,1576,39,1865
1876,6,1,0,129,111,1699,39,1985
1877,6,0,0,7,111,1714,38,1876
1878,27,0,0,7,111,1745,39,1929
1879,27,1,0,7,112,1759,39,1945
1880,27,1,0,7,111,1766,38,1950
1881,27,0,0,7,111,1781,39,1965
1882,27,1,0,7,111,1783,38,1967
1883,27,1,0,7,111,1791,39,1976
1884,27,0,0,7,111,1800,38,1983
1885,27,1,0,10,111,1802,38,1989
1886,27,1,0,1,111,1806,38,1984
1887,27,0,0,149,111,1810,39,2136
1888,27,0,0,138,111,1808,38,2122
1889,27,1,0,132,112,1814,38,2124
1890,27,0,0,130,111,1814,39,2121
1891,27,0,0,129,112,1817,38,2123
1892,27,1,0,127,112,1817,39,2123
1893,7,0,0,127,112,1818,39,2103
1894,7,0,0,125,112,1822,39,2105
1895,7,1,0,126,111,1823,39,2107
1896,7,0,0,124,111,1818,38,2098
1897,7,0,0,0,112,1821,39,1979
1898,7,1,0,0,104,1,38,151
1899,7,0,0,0,104,1,38,150
1900,6,1,0,0,103,1,38,149
1901,7,0,0,0,103,1,38,149
1902,6,1,0,0,103,1,38,149
1903,7,1,0,1,103,1,38,151
1904,7,0,0,0,104,1,39,151
1905,7,0,0,0,104,1,38,150
1906,7,0,0,1,103,1,38,150
1907,7,0,0,0,104,1,39,151
1908,7,0,0,0,104,1,38,150
1909,6,0,0,0,103,1,39,149
1910,7,0,0,0,103,1,38,149
1911,7,0,0,0,104,1,39,151
1912,7,1,0,0,104,1,39,152
1913,7,0,0,0,104,0,38,149
1914,7,1,0,0,105,1,39,153
1915,7,0,0,0,104,39,38,188
1916,7,1,0,1,103,39,39,190
1917,7,0,0,0,104,39,38,188
1918,7,0,0,0,104,38,39,188
1919,7,0,0,0,105,37,38,187
1920,7,0,0,0,103,37,38,185
1921,7,0,0,1,104,37,39,188
1922,7,0,0,0,103,37,39,186
1923,7,1,0,0,105,38,39,190
1924,6,1,0,0,104,38,38,187
1925,7,0,0,0,103,38,39,187
1926,7,0,0,0,104,38,39,188
1927,7,0,0,0,105,37,39,188
1928,7,1,0,0,105,37,38,188
1929,7,1,0,145,105,37,39,334
1930,6,0,0,133,104,37,38,318
1931,6,0,0,128,104,37,39,314
1932,7,1,0,127,104,38,40,317
1933,7,0,0,127,104,38,38,314
1934,7,0,0,125,104,37,38,311
1935,7,0,0,126,104,38,38,313
1936,7,0,0,124,104,37,39,311
1937,7,0,0,123,104,38,39,311
1938,6,0,0,0,104,36,39,185
1939,7,0,0,0,111,1281,38,1437
1940,7,1,0,0,111,1591,38,1748
1941,7,0,0,0,111,1713,38,1869
1942,7,0,0,0,111,1721,38,1877
1943,7,1,0,0,111,1744,39,1902
1944,7,0,0,0,112,1767,38,1924
1945,7,0,0,10,111,1768,38,1934
1946,7,0,0,10,112,1786,39,1954
1947,7,0,0,0,111,1789,39,1946
1948,6,0,0,0,111,1800,39,1956
1949,7,0,0,0,112,1798,39,1956
1950,7,0,0,1,111,1806,39,1964
1951,7,0,0,0,112,1808,38,1965
1952,7,1,0,0,111,1809,39,1967
1953,6,0,0,0,111,1811,38,1966
1954,7,0,0,0,112,1811,39,1969
1955,7,0,0,0,111,1813,38,1969
1956,6,1,0,0,111,1816,39,1973
1957,7,1,0,0,112,1816,38,1974
1958,6,1,0,0,111,1822,39,1979
1959,6,0,0,0,111,1816,39,1972
1960,6,0,0,0,111,1824,38,1979
1961,7,1,0,0,111,1827,39,1985
1962,7,0,0,0,111,1823,38,1979
1963,7,0,0,0,111,1826,38,1982
1964,7,0,0,0,111,1823,39,1980
1965,7,1,0,0,104,1,38,151
1966,7,1,0,147,104,1,38,298
1967,7,1,0,133,103,1,39,284
1968,7,0,0,129,103,1,38,278
1969,7,0,0,129,103,1,39,279
1970,7,1,0,127,103,1,38,277
1971,7,1,0,126,104,1,39,278
1972,7,0,0,125,104,0,39,275
1973,7,1,0,124,103,1,38,274
1974,6,1,0,123,103,1,39,273
1975,7,1,0,0,104,1,39,152
1976,7,0,0,0,104,1,39,151
1977,7,0,0,0,104,1,38,150
1978,7,1,0,0,104,1,38,151
1979,7,0,0,0,104,1,39,151
1980,7,0,0,0,105,1,39,152
1981,7,0,0,0,104,1,38,150
1982,7,0,0,0,103,41,38,189
1983,7,0,0,0,104,38,38,187
1984,7,0,0,0,104,38,38,187
1985,6,1,0,0,104,37,38,186
1986,7,0,0,1,103,37,38,186
1987,7,1,0,0,104,38,39,189
1988,7,0,0,0,104,38,39,188
1989,7,0,0,0,105,38,38,188
1990,7,1,0,0,104,38,39,189
1991,7,0,0,0,104,37,38,186
1992,7,0,0,0,103,38,38,186
1993,6,0,0,0,103,38,38,185
1994,7,0,0,0,104,37,39,187
1995,6,0,0,0,103,38,38,185
1996,7,0,0,0,103,38,38,186
1997,7,0,0,0,104,38,39,188
1998,7,0,0,0,104,38,39,188
1999,7,1,0,0,105,37,39,189
2000,7,0,0,0,112,1505,39,1663
2001,7,0,0,0,111,1678,38,1834
2002,7,1,0,0,111,1753,39,1911
2003,7,0,0,0,111,1744,39,1901
2004,7,1,0,0,111,1755,38,1912
2005,7,0,0,0,112,1765,39,1923
2006,7,0,0,10,112,1774,39,1942
2007,7,0,0,7,111,1777,39,1941
2008,7,0,0,146,111,1791,38,2093
2009,7,1,0,132,111,1790,39,2080
2010,7,1,0,129,111,1792,39,2079
2011,7,0,0,128,111,1798,38,2082
2012,7,0,0,127,111,1799,39,2083
2013,6,1,0,126,111,1801,39,2084
2014,7,0,0,125,112,1807,38,2089
2015,7,1,0,124,113,1802,38,2085
2016,7,0,0,123,111,1810,39,2090
2017,7,1,0,0,112,1809,38,1967
2018,7,1,0,0,112,1810,38,1968
2019,7,0,0,0,111,1815,38,1971
2020,7,0,0,0,112,1811,38,1968
2021,7,0,0,0,111,1814,38,1970
2022,7,1,0,0,112,1814,39,1973
2023,7,0,0,0,105,1,39,152
2024,7,0,0,0,104,1,38,150
2025,7,0,0,0,104,1,38,150
2026,7,0,0,1,104,1,39,152
2027,7,1,0,1,104,1,38,152
2028,6,0,0,0,104,1,39,150
2029,6,0,0,0,104,1,39,150
2030,7,0,0,0,104,1,39,151
2031,7,0,0,0,103,1,38,149
2032,6,0,0,0,104,1,38,149
2033,7,1,0,1,103,1,39,152
2034,7,1,0,0,104,1,38,151
2035,7,0,0,1,104,1,38,151
2036,7,0,0,0,104,1,38,150
2037,7,0,0,10,104,41,38,200
2038,7,0,0,7,103,38,38,193
2039,6,0,0,7,104,37,39,193
2040,7,0,0,7,104,38,38,194
2041,7,1,0,7,105,37,38,195
2042,6,0,0,7,103,36,39,191
2043,7,0,0,148,104,37,39,335
2044,7,0,0,138,103,38,38,324
2045,7,0,0,138,104,37,39,325
2046,7,0,0,136,104,38,38,323
2047,7,0,0,135,104,37,38,321
2048,7,0,0,133,103,38,39,320
2049,7,0,0,132,104,37,39,319
2050,7,1,0,132,104,38,38,320
2051,7,0,0,132,104,38,38,319
2052,7,0,0,131,104,38,38,318
2053,7,1,0,131,103,37,39,318
2054,7,0,0,131,104,37,38,317
2055,7,0,0,130,103,37,39,316
2056,7,1,0,132,104,37,38,319
2057,7,0,0,130,103,37,38,315
2058,7,0,0,129,103,38,39,316
2059,7,1,0,129,104,37,39,317
2060,7,1,0,130,104,38,38,318
2061,6,1,0,130,104,37,38,316
2062,7,0,0,128,104,37,38,314
2063,7,0,0,128,104,36,38,313
2064,7,0,0,129,104,37,39,316
2065,7,1,0,127,104,37,38,314
2066,7,0,0,128,111,1325,38,1609
2067,7,0,0,127,110,1605,37,1886
2068,7,0,0,0,111,1725,37,1880
2069,7,0,0,0,111,1768,38,1924
2070,7,1,0,0,111,1744,37,1900
2071,7,1,0,0,111,1758,38,1915
2072,7,0,0,456,111,1758,37,2369
2073,7,1,0,450,111,1770,38,2377
2074,7,0,0,449,111,1781,37,2385
2075,7,0,0,449,111,1789,37,2393
2076,7,0,0,449,111,1790,37,2394
2077,7,1,0,450,111,1797,38,2404
2078,7,0,0,450,111,1794,38,2400
2079,7,1,0,448,111,1798,37,2402
2080,7,1,0,447,112,1798,38,2403
2081,7,1,0,449,111,1801,37,2406
2082,7,0,0,451,111,1801,37,2407
2083,7,0,0,451,113,1807,37,2415
2084,7,1,0,447,111,1808,37,2411
2085,7,0,0,1,111,1806,37,1962
2086,7,0,0,1,112,1810,38,1968
2087,7,0,0,1,112,1809,37,1966
2088,7,1,0,1,112,1814,38,1973
2089,7,0,0,199,112,1813,37,2168
2090,7,0,0,153,111,1809,38,2118
2091,7,1,0,155,104,1,38,306
2092,7,0,0,157,104,1,38,307
2093,7,0,0,150,104,1,38,300
2094,7,0,0,145,104,1,37,294
2095,7,0,0,143,104,1,38,293
2096,7,0,0,141,104,1,38,291
2097,7,1,0,139,104,1,37,289
2098,7,0,0,138,104,1,37,287
2099,7,0,0,136,104,1,38,286
2100,7,0,0,135,104,1,38,285
2101,7,0,0,133,104,1,38,283
2102,6,0,0,132,104,1,37,280
2103,7,0,0,131,104,1,37,280
2104,7,0,0,130,103,39,38,317
2105,7,1,0,129,103,38,38,316
2106,7,0,0,129,103,38,38,315
2107,7,1,0,127,104,38,38,315
2108,6,0,0,127,105,37,38,313
2109,7,0,0,126,104,37,37,311
2110,7,0,0,125,104,38,38,312
2111,7,0,0,125,104,36,37,309
2112,7,0,0,0,104,37,38,186
2113,7,0,0,1,103,38,37,186
2114,7,0,0,0,104,38,38,187
2115,7,0,0,0,104,37,38,186
2116,7,0,0,0,104,37,38,186
2117,7,0,0,0,104,37,37,185
2118,7,0,0,0,104,37,38,186
2119,7,1,0,0,103,37,37,185
2120,7,1,0,0,104,37,38,187
2121,7,1,0,0,104,37,37,186
2122,7,0,0,0,103,38,37,185
2123,7,0,0,0,104,38,37,186
2124,7,0,0,0,104,37,37,185
2125,7,0,0,0,104,38,38,187
2126,7,0,0,1,103,37,38,186
2127,7,1,0,10,104,37,38,197
2128,7,0,0,0,104,38,38,187
2129,7,0,0,0,103,37,37,184
2130,7,0,0,0,104,37,38,186
2131,7,0,0,1,104,37,38,187
2132,7,0,0,150,104,37,38,336
2133,7,0,0,137,104,38,38,324
2134,7,0,0,131,105,38,39,320
2135,7,0,0,128,103,37,37,312
2136,7,0,0,128,111,1375,37,1658
2137,7,0,0,126,111,1621,37,1902
2138,6,0,0,126,111,1727,37,2007
2139,7,2,0,125,111,1768,37,2050
2140,6,1,0,123,111,1742,37,2020
2141,7,0,0,123,110,1755,37,2032
2142,7,0,0,0,111,1757,38,1913
2143,6,0,0,0,111,1767,37,1921
2144,7,0,0,0,111,1776,37,1931
2145,6,0,0,0,111,1785,38,1940
2146,7,0,0,0,111,1789,37,1944
2147,7,0,0,0,111,1790,38,1946
2148,7,0,0,0,111,1797,38,1953
2149,6,0,0,0,111,1800,38,1955
2150,7,0,0,0,110,1799,37,1953
2151,7,2,0,0,111,1805,38,1963
2152,7,1,0,0,111,1802,37,1958
2153,6,0,0,1,111,1807,38,1963
2154,7,0,0,0,111,1809,37,1964
2155,6,1,0,0,111,1809,38,1965
2156,7,0,0,0,112,1811,38,1968
2157,7,0,0,1,111,1810,37,1966
2158,7,0,0,0,111,1815,38,1971
2159,7,0,0,1,111,1816,38,1973
2160,7,0,0,0,111,1814,37,1969
2161,7,0,0,0,111,1813,37,1968
2162,6,0,0,1,111,1813,38,1969
2163,7,0,0,0,111,1818,38,1974
2164,7,0,0,0,104,0,38,149
2165,6,0,0,0,103,1,38,148
2166,6,1,0,1,104,1,38,151
2167,7,0,0,0,104,1,37,149
2168,7,0,0,0,103,1,37,148
2169,6,0,0,0,104,1,37,148
2170,7,0,0,144,103,1,38,293
2171,7,1,0,132,103,1,37,281
2172,7,0,0,128,104,1,38,278
2173,7,0,0,126,104,1,37,275
2174,7,0,0,127,103,1,37,275
2175,7,0,0,126,103,1,37,274
2176,7,1,0,125,104,1,37,275
2177,7,0,0,124,104,1,38,274
2178,7,1,0,123,104,1,37,273
2179,7,0,0,1,103,39,38,188
2180,7,0,0,0,103,41,37,188
2181,7,0,0,0,104,38,37,186
2182,6,1,0,0,104,38,37,186
2183,7,0,0,0,103,37,37,184
2184,6,1,0,0,103,38,38,186
2185,7,0,0,0,103,37,37,184
2186,7,0,0,0,103,37,38,185
2187,7,0,0,11,103,37,37,195
2188,7,1,0,10,103,38,37,196
2189,6,0,0,0,104,37,37,184
2190,7,0,0,0,103,38,37,185
2191,7,1,0,0,104,38,37,187
2192,7,0,0,1,103,37,38,186
2193,7,0,0,0,103,38,37,185
2194,6,0,0,0,103,38,38,185
2195,6,0,0,0,103,38,37,184
2196,7,0,0,0,103,37,37,184
2197,7,1,0,1,103,38,37,187
2198,7,0,0,0,103,36,38,184
2199,7,1,0,0,103,37,37,185
2200,7,0,0,0,103,37,37,184
2201,7,1,0,0,103,37,38,186
2202,7,0,0,0,103,38,38,186
2203,7,1,0,140,103,38,38,327
2204,6,0,0,140,103,38,37,324
2205,7,0,0,128,104,38,38,315
2206,7,0,0,128,104,37,38,314
2207,6,0,0,127,103,38,38,312
2208,7,0,0,126,104,37,37,311
2209,7,0,0,125,111,1448,37,1728
2210,6,0,0,123,111,1645,37,1922
2211,7,0,0,124,111,1737,38,2017
2212,7,0,0,0,111,1768,38,1924
2213,6,0,0,0,112,1784,37,1939
2214,6,0,0,0,111,1755,37,1909
2215,7,0,0,0,111,1762,37,1917
2216,7,1,0,10,110,1769,37,1934
2217,6,0,0,7,111,1783,37,1944
2218,7,0,0,7,111,1782,37,1944
2219,7,0,0,7,110,1783,37,1944
2220,7,1,0,7,110,1791,37,1953
2221,6,0,0,7,111,1794,38,1956
2222,7,0,0,7,111,1793,37,1955
2223,7,0,0,7,112,1797,37,1960
2224,7,0,0,7,110,1801,38,1963
2225,7,0,0,7,110,1802,37,1963
2226,7,0,0,146,111,1799,38,2101
2227,7,1,0,144,111,1807,37,2107
2228,7,0,0,135,111,1814,37,2104
2229,7,0,0,135,111,1808,37,2098
2230,6,0,0,134,111,1806,38,2095
2231,7,1,0,133,111,1813,37,2102
2232,7,0,0,133,111,1814,37,2102
2233,7,1,0,132,111,1811,37,2099
2234,7,0,0,132,111,1815,37,2102
2235,7,0,0,132,105,1,37,282
2236,7,1,0,131,104,2,37,282
2237,7,0,0,130,104,1,37,279
2238,7,0,0,130,103,1,37,278
2239,7,1,0,129,103,1,38,279
2240,7,0,0,130,104,1,38,280
2241,7,0,0,129,103,1,38,278
2242,7,0,0,128,104,0,37,276
2243,7,0,0,7,104,1,37,156
2244,7,1,0,7,103,1,37,156
2245,7,1,0,7,104,1,37,157
2246,6,0,0,10,104,1,37,158
2247,7,1,0,0,103,1,37,149
2248,7,1,0,0,103,2,37,150
2249,7,0,0,0,105,38,37,187
2250,7,0,0,1,104,38,37,187
2251,6,0,0,0,104,37,37,184
2252,6,0,0,0,103,38,38,185
2253,7,1,0,0,104,37,37,186
2254,7,0,0,147,103,36,37,330
2255,7,0,0,132,103,36,37,315
2256,7,0,0,127,103,36,38,311
2257,6,0,0,127,103,37,37,310
2258,7,0,0,126,103,36,37,309
2259,6,1,0,124,103,37,37,308
2260,7,0,0,123,104,36,38,308
2261,6,0,0,122,102,38,37,305
2262,7,0,0,123,104,37,38,309
2263,7,0,0,0,104,37,38,186
2264,7,0,0,0,104,38,37,186
2265,7,1,0,0,104,37,38,187
2266,7,0,0,0,103,37,38,185
2267,6,0,0,0,103,37,37,183
2268,7,0,0,0,103,37,37,184
2269,7,0,0,0,103,36,37,183
2270,7,1,0,1,103,37,37,186
2271,6,0,0,0,103,37,38,184
2272,7,0,0,0,103,37,37,184
2273,7,0,0,0,110,1517,37,1671
2274,7,1,0,0,110,1687,37,1842
2275,6,0,0,0,110,1747,38,1901
2276,6,0,0,0,110,1770,38,1924
2277,7,0,0,0,111,1752,37,1907
2278,7,0,0,0,109,1752,37,1905
2279,7,0,0,0,110,1770,37,1924
2280,6,0,0,0,111,1774,37,1928
2281,6,0,0,0,109,1779,37,1931
2282,6,1,0,0,110,1785,38,1940
2283,6,0,0,0,111,1791,37,1945
2284,7,1,0,1,110,1791,38,1948
2285,7,0,0,0,110,1797,37,1951
2286,7,0,0,0,111,1793,37,1948
2287,6,0,0,0,111,1801,37,1955
2288,6,0,0,0,111,1803,37,1957
2289,7,0,0,0,111,1801,37,1956
2290,6,0,0,0,111,1807,37,1961
2291,7,1,0,0,110,1807,37,1962
2292,6,0,0,0,110,1807,37,1960
2293,7,0,0,0,109,1810,37,1963
2294,7,1,0,145,111,1802,37,2103
2295,7,0,0,131,104,1,37,280
2296,7,0,0,126,103,1,37,274
2297,7,0,0,125,103,1,37,273
2298,6,0,0,125,103,1,37,272
2299,7,0,0,125,103,1,38,274
2300,7,0,0,122,102,1,37,269
2301,7,1,0,123,102,1,38,272
2302,7,0,0,122,103,1,38,271
2303,7,0,0,0,103,1,38,149
2304,7,0,0,0,103,1,38,149
2305,6,0,0,0,102,1,37,146
2306,7,1,0,10,103,0,37,158
2307,7,0,0,10,104,1,37,159
2308,6,1,0,0,102,1,37,147
2309,7,0,0,0,103,1,37,148
2310,6,1,0,0,103,1,37,148
2311,7,0,0,0,103,38,37,185
2312,7,0,0,1,103,38,37,186
2313,7,0,0,0,103,37,37,184
2314,7,0,0,1,104,36,38,186
2315,7,0,0,0,103,36,37,183
2316,6,0,0,0,103,37,38,184
2317,6,1,0,0,103,36,37,183
2318,7,0,0,0,103,37,37,184
2319,6,0,0,0,103,37,37,183
2320,7,0,0,0,103,37,37,184
2321,6,1,0,0,104,37,37,185
2322,7,0,0,0,103,35,38,183
2323,6,1,0,1,103,36,37,184
2324,7,0,0,0,103,37,38,185
2325,7,0,0,0,104,37,38,186
2326,7,0,0,0,111,1541,37,1696
2327,7,0,0,1,110,1697,38,1853
2328,7,0,0,0,110,1728,37,1882
2329,6,0,0,0,110,1745,38,1899
2330,7,1,0,142,111,1757,37,2055
2331,7,0,0,129,111,1758,38,2043
2332,7,0,0,127,110,1773,38,2055
2333,7,1,0,126,111,1778,38,2061
2334,7,1,0,125,111,1791,38,2073
2335,7,1,0,124,110,1790,37,2069
2336,6,0,0,123,110,1799,37,2075
2337,6,1,0,122,111,1801,38,2079
2338,7,1,0,0,111,1799,37,1955
2339,7,1,0,0,111,1806,37,1962
2340,334,0,0,0,111,1808,37,2290
2341,434,0,0,0,111,1808,37,2390
2342,426,0,0,0,111,1808,37,2382
2343,424,1,0,0,110,1813,38,2386
2344,419,0,0,0,110,1811,37,2377
2345,424,0,0,0,111,1817,37,2389
2346,431,1,0,0,111,1816,37,2396
2347,425,0,0,0,111,1818,37,2391
2348,419,1,0,0,103,1,37,561
2349,418,0,0,0,104,0,37,559
2350,424,0,0,0,103,1,37,565
2351,428,1,0,0,104,1,37,571
2352,426,0,0,0,103,1,37,567
2353,419,0,0,0,104,1,37,561
2354,417,0,0,0,103,0,37,557
2355,395,0,0,0,103,1,37,536
2356,397,1,0,0,104,0,37,539
2357,394,0,0,0,104,1,38,537
2358,397,0,0,0,103,1,37,538
2359,436,0,0,0,103,0,38,577
2360,427,0,0,0,104,1,37,569
2361,426,1,0,0,103,1,38,569
2362,427,0,0,0,103,38,37,605
2363,435,0,0,0,103,37,38,613
2364,430,0,0,0,103,38,38,609
2365,440,0,0,0,103,36,37,616
2366,436,1,0,0,104,36,37,614
2367,423,1,0,10,103,37,38,612
2368,424,0,0,6,103,36,37,606
2369,432,0,0,150,104,38,37,761
2370,420,0,0,134,104,37,37,732
2371,440,1,0,129,103,36,37,746
2372,430,0,0,127,102,36,37,732
2373,430,1,0,127,103,36,37,734
2374,434,0,0,125,104,37,37,737
2375,429,1,0,124,103,36,38,731
2376,424,0,0,123,103,36,37,723
2377,438,0,0,122,104,37,37,738
2378,431,0,0,0,103,37,37,608
2379,424,1,0,0,105,36,37,603
2380,421,0,0,0,103,36,37,597
2381,424,0,0,0,103,37,38,602
2382,434,1,0,0,111,1043,37,1626
2383,427,1,0,0,110,1584,38,2160
2384,420,0,0,0,111,1721,38,2290
2385,420,0,0,0,110,1734,38,2302
2386,424,1,0,0,111,1754,37,2327
2387,417,0,0,0,110,1759,38,2324
2388,396,0,0,0,110,1766,37,2309
2389,397,0,0,0,111,1781,38,2327
2390,393,0,0,0,111,1784,37,2325
2391,390,0,0,0,110,1789,38,2327
2392,389,0,0,0,110,1799,37,2335
2393,395,0,0,0,110,1801,37,2343
2394,391,0,0,0,111,1811,37,2350
2395,392,0,0,0,110,1808,37,2347
2396,393,0,0,0,111,1813,38,2355
2397,393,0,0,0,111,1817,38,2359
2398,409,0,0,0,111,1817,37,2374
2399,330,0,0,0,111,1822,37,2300
2400,330,0,0,0,110,1811,37,2288
2401,331,1,0,0,111,1824,38,2305
2402,333,0,0,0,104,1,38,476
2403,334,2,0,0,104,1,37,478
2404,336,0,0,7,104,1,38,486
2405,6,2,0,7,104,1,37,157
2406,7,1,0,7,104,1,38,158
2407,7,0,0,155,103,0,38,303
2408,7,0,0,139,103,2,37,288
2409,7,0,0,136,104,1,37,285
2410,7,0,0,137,103,1,37,285
2411,7,0,0,136,104,1,37,285
2412,7,0,0,136,104,2,37,286
2413,7,1,0,135,103,1,37,284
2414,7,0,0,135,103,1,37,283
2415,7,0,0,133,103,0,37,280
2416,7,0,0,132,103,39,38,319
2417,6,1,0,132,105,37,38,319
2418,7,0,0,132,104,36,37,316
2419,7,0,0,132,103,37,38,317
2420,7,0,0,132,103,37,38,317
2421,7,1,0,132,103,37,38,318
2422,7,0,0,132,104,37,38,318
2423,7,0,0,130,103,38,37,315
2424,7,0,0,130,104,37,38,316
2425,7,0,0,131,104,38,37,317
2426,7,0,0,7,104,37,37,192
2427,7,0,0,7,104,37,37,192
2428,7,0,0,7,104,37,38,193
2429,7,2,0,89,103,37,38,276
2430,7,2,0,7,103,36,37,192
2431,6,0,0,7,104,36,38,191
2432,7,1,0,7,103,37,37,192
2433,7,0,0,7,103,37,37,191
2434,7,1,0,147,103,36,38,332
2435,7,1,0,137,104,36,37,322
2436,7,1,0,137,103,36,38,322
2437,7,1,0,135,104,37,38,322
2438,7,1,0,135,103,37,37,320
2439,6,0,0,135,102,38,37,318
2440,7,0,0,134,104,36,38,319
2441,7,1,0,133,104,36,37,318
2442,7,0,0,132,103,36,38,316
2443,7,0,0,131,104,36,37,315
2444,7,1,0,129,104,37,37,315
2445,7,0,0,128,103,37,37,312
2446,6,0,0,124,104,36,38,308
2447,7,1,0,124,103,37,38,310
2448,7,1,0,123,104,36,38,309
2449,7,0,0,0,104,37,37,185
2450,7,0,0,0,103,37,38,185
2451,6,0,0,0,103,37,38,184
2452,7,0,0,0,103,36,37,183
2453,6,0,0,1,104,35,38,184
2454,7,0,0,0,104,36,37,184
2455,7,0,0,0,104,36,37,184
2456,7,0,0,0,102,37,37,183
2457,7,0,0,0,104,36,37,184
2458,7,0,0,0,104,36,37,184
2459,7,0,0,0,103,36,37,183
2460,7,0,0,0,103,36,38,184
2461,7,0,0,0,104,37,37,185
2462,6,0,0,1,103,36,37,183
2463,6,0,0,1,103,35,38,183
2464,6,1,0,1,103,36,37,184
2465,6,0,0,1,102,36,37,182
2466,6,0,0,1,103,36,37,183
2467,6,0,0,1,102,35,37,181
2468,7,0,0,1,103,35,37,183
2469,6,0,0,0,104,36,37,183
2470,6,0,0,0,111,1418,38,1573
2471,6,0,0,0,111,1627,37,1781
2472,7,0,0,0,111,1731,37,1886
2473,6,0,0,0,110,1730,37,1883
2474,7,0,0,1,111,1747,38,1904
2475,6,1,0,0,111,1755,37,1910
2476,7,0,0,144,111,1770,37,2069
2477,7,0,0,130,110,1773,37,2057
2478,6,0,0,126,110,1786,37,2065
2479,7,1,0,126,110,1792,37,2073
2480,7,0,0,126,111,1795,38,2077
2481,6,1,0,124,111,1795,37,2074
2482,7,0,0,124,111,1801,37,2080
2483,7,0,0,123,111,1806,38,2085
2484,7,0,0,122,110,1805,38,2082
2485,7,1,0,1,111,1817,38,1975
2486,7,1,0,0,111,1814,37,1970
2487,7,0,0,0,110,1814,37,1968
2488,7,0,0,0,104,1,39,151
2489,7,1,0,0,103,1,37,149
2490,7,1,0,0,103,1,38,150
2491,7,1,0,0,103,1,38,150
2492,7,0,0,1,103,1,37,149
2493,6,0,0,0,103,1,37,147
2494,6,1,0,0,103,1,37,148
2495,7,0,0,1,102,1,38,149
2496,6,0,0,0,103,1,38,148
2497,7,0,0,0,103,0,37,147
2498,7,0,0,0,104,1,38,150
2499,6,1,0,0,103,1,37,148
2500,7,0,0,1,103,0,37,148
2501,7,1,0,0,102,38,37,185
2502,5,1,0,1,101,38,38,184
2503,6,0,0,0,104,37,37,184
2504,7,2,0,10,103,36,37,195
2505,7,0,0,0,104,36,38,185
2506,7,0,0,0,103,36,38,184
2507,7,1,0,0,103,36,37,184
2508,6,0,0,0,104,36,37,183
2509,7,0,0,0,103,38,37,185
2510,7,1,0,0,103,36,37,184
2511,7,1,0,0,103,36,37,184
2512,6,2,0,141,103,36,37,325
2513,7,0,0,127,103,36,37,310
2514,7,0,0,127,103,35,37,309
2515,7,1,0,125,103,36,37,309
2516,7,0,0,125,104,37,37,310
2517,7,0,0,124,104,36,38,309
2518,6,0,0,124,103,37,38,308
2519,7,1,0,123,104,37,39,311
2520,7,1,0,122,103,37,37,307
2521,7,0,0,0,104,37,37,185
2522,7,0,0,0,103,36,37,183
2523,7,1,0,0,103,37,37,185
2524,6,0,0,0,103,38,38,185
2525,7,0,0,0,104,36,37,184
2526,7,0,0,0,104,36,37,184
2527,7,0,0,0,103,36,38,184
2528,6,0,0,0,104,36,37,183
2529,7,1,0,0,103,38,37,186
2530,6,1,0,0,104,37,38,186
2531,7,1,0,0,103,36,37,184
2532,7,0,0,0,103,37,38,185
2533,6,1,0,0,104,36,37,184
2534,7,0,0,0,104,36,37,184
2535,6,0,0,1,103,36,37,183
2536,329,0,0,0,104,36,38,507
2537,7,1,0,10,105,36,37,196
2538,7,1,0,7,104,37,38,194
2539,7,0,0,7,104,37,37,192
2540,6,0,0,7,103,36,38,190
2541,7,0,0,7,104,36,37,191
2542,7,0,0,7,103,36,37,190
2543,7,0,0,7,103,36,37,190
2544,7,0,0,145,103,36,37,328
2545,7,0,0,136,104,36,37,320
2546,7,0,0,136,103,37,38,321
2547,7,0,0,133,103,37,38,318
2548,7,0,0,150,103,37,38,335
2549,7,0,0,134,104,37,37,319
2550,7,1,0,134,104,36,37,319
2551,6,0,0,133,103,36,38,316
2552,7,1,0,132,103,36,38,317
2553,7,0,0,132,105,37,37,318
2554,7,0,0,132,103,35,38,315
2555,7,0,0,131,103,36,37,314
2556,7,0,0,131,103,36,38,315
2557,7,0,0,131,104,36,37,315
2558,7,0,0,130,103,37,37,314
2559,7,0,0,129,105,36,38,315
2560,7,0,0,129,103,36,37,312
2561,7,0,0,128,103,36,37,311
2562,7,0,0,7,104,37,38,193
2563,7,0,0,7,104,36,38,192
2564,7,1,0,7,103,36,38,192
2565,7,0,0,7,104,36,37,191
2566,7,0,0,7,103,36,37,190
2567,7,0,0,7,104,37,37,192
2568,6,0,0,7,103,36,37,189
2569,7,0,0,7,103,36,38,191
2570,7,0,0,7,102,36,37,189
2571,7,1,0,1,104,36,38,187
2572,7,0,0,143,104,36,38,328
2573,7,0,0,130,102,36,37,312
2574,7,0,0,207,103,36,37,390
2575,6,0,0,128,103,36,38,311
2576,449,0,0,126,103,35,37,750
2577,431,0,0,125,103,36,37,732
2578,7,0,0,124,103,36,37,307
2579,6,1,0,124,103,36,38,308
2580,7,0,0,122,110,1298,37,1574
2581,7,0,0,123,111,1585,37,1863
2582,7,0,0,0,110,1685,37,1839
2583,7,0,0,1,110,1723,37,1878
2584,6,0,0,1,111,1741,37,1896
2585,7,0,0,1,111,1749,38,1906
2586,7,1,0,1,111,1771,37,1928
2587,7,0,0,0,111,1777,37,1932
2588,7,0,0,0,112,1776,37,1932
2589,7,1,0,1,111,1782,37,1939
2590,7,0,0,0,112,1789,37,1945
2591,7,1,0,0,111,1795,37,1951
2592,6,1,0,0,111,1797,37,1952
2593,7,0,0,0,111,1799,37,1954
2594,7,1,0,0,111,1803,38,1960
2595,7,0,0,1,112,1806,37,1963
2596,7,0,0,1,112,1803,38,1961
2597,7,0,0,0,112,1808,37,1964
2598,7,1,0,0,113,1811,38,1970
2599,7,0,0,0,111,1810,37,1965
2600,7,0,0,0,103,1,37,148
2601,7,1,0,0,103,1,38,150
2602,7,0,0,0,103,1,37,148
2603,7,0,0,0,104,1,38,150
2604,7,0,0,0,104,1,38,150
2605,7,1,0,0,103,0,37,148
2606,7,0,0,0,103,1,38,149
2607,8,0,0,1,104,2,37,152
2608,7,1,0,1,104,1,38,152
2609,7,0,0,0,104,1,37,149
2610,7,0,0,0,103,1,37,148
2611,7,0,0,1,104,1,37,150
2612,7,0,0,145,104,1,37,294
2613,7,1,0,132,103,1,38,282
2614,7,0,0,127,104,1,37,276
2615,7,0,0,128,104,1,37,277
2616,7,0,0,126,104,2,37,276
2617,7,0,0,124,104,38,37,310
2618,7,1,0,125,103,37,37,310
2619,7,2,0,124,103,38,37,311
2620,7,0,0,122,103,36,37,305
2621,7,0,0,0,104,37,37,185
2622,7,0,0,0,103,36,37,183
2623,7,0,0,0,103,36,37,183
2624,6,0,0,0,103,36,37,182
2625,7,0,0,0,103,35,38,183
2626,7,0,0,0,103,36,37,183
2627,6,0,0,0,103,36,37,182
2628,7,0,0,0,104,38,37,186
2629,7,0,0,1,103,36,37,184
2630,7,1,0,7,104,37,37,193
2631,7,0,0,0,105,35,38,185
2632,7,0,0,0,104,35,37,183
2633,6,1,0,0,104,37,37,185
2634,6,0,0,0,104,37,38,185
2635,7,0,0,0,103,38,38,186
2636,6,0,0,0,103,37,37,183
2637,7,1,0,0,104,36,37,185
2638,7,1,0,0,104,36,37,185
2639,7,0,0,1,103,36,38,185
2640,7,0,0,1,103,36,37,184
2641,7,0,0,0,103,36,38,184
2642,7,0,0,0,103,37,38,185
2643,7,0,0,0,104,36,37,184
2644,7,0,0,0,104,36,38,185
2645,7,1,0,0,103,36,37,184
2646,6,0,0,0,103,37,37,183
2647,6,0,0,143,104,36,37,326
2648,7,0,0,129,104,37,38,315
2649,6,0,0,126,103,37,37,309
2650,6,0,0,126,103,37,37,309
2651,7,0,0,125,103,36,37,308
2652,7,0,0,124,104,37,37,309
2653,7,0,0,124,105,36,37,309
2654,6,0,0,122,104,36,37,305
2655,7,0,0,122,104,36,38,307
2656,7,0,0,0,103,37,37,184
2657,7,1,0,0,103,37,38,186
2658,7,0,0,0,103,36,37,183
2659,6,0,0,0,103,36,37,182
2660,7,2,0,0,104,38,37,188
2661,7,0,0,1,104,37,37,186
2662,7,0,0,0,104,36,37,184
2663,7,1,0,1,103,37,38,187
2664,7,0,0,1,103,36,38,185
2665,7,0,0,1,103,36,37,184
2666,7,0,0,1,103,36,38,185
2667,7,0,0,0,103,36,37,183
2668,7,0,0,0,104,37,38,186
2669,7,0,0,0,103,36,37,183
2670,7,0,0,0,104,37,38,186
2671,7,0,0,0,104,37,37,185
2672,7,0,0,0,103,37,37,184
2673,7,0,0,0,104,36,37,184
2674,7,0,0,0,104,37,37,185
2675,7,0,0,0,104,36,38,185
2676,6,1,0,1,104,36,37,185
2677,7,0,0,0,103,36,37,183
2678,7,0,0,0,103,36,37,183
2679,6,0,0,0,103,36,37,182
2680,7,1,0,0,105,36,37,186
2681,7,0,0,0,103,38,37,185
2682,7,0,0,0,103,36,37,183
2683,7,1,0,0,104,36,37,185
2684,7,0,0,0,103,36,37,183
2685,7,0,0,0,104,36,38,185
2686,7,0,0,0,104,37,37,185
2687,7,0,0,0,103,36,38,184
2688,7,0,0,149,104,36,37,333
2689,6,1,0,134,104,36,37,318
2690,6,1,0,129,103,35,37,311
2691,7,0,0,130,103,36,37,313
2692,7,0,0,131,104,36,37,315
2693,7,0,0,131,105,36,37,316
2694,7,1,0,131,103,36,37,315
2695,7,1,0,130,103,36,37,314
2696,7,0,0,131,103,37,37,315
2697,6,0,0,128,103,36,37,310
2698,6,0,0,128,103,38,38,313
2699,7,0,0,130,103,36,37,313
2700,7,0,0,127,103,36,38,311
2701,7,0,0,7,104,36,38,192
2702,7,0,0,7,103,36,37,190
2703,7,0,0,7,104,36,38,192
2704,7,0,0,7,103,38,38,193
2705,7,0,0,7,104,36,38,192
2706,6,0,0,7,104,36,38,191
2707,7,1,0,7,103,36,37,191
2708,7,0,0,7,103,36,38,191
2709,7,1,0,7,104,36,38,193
2710,7,0,0,149,104,37,37,334
2711,7,0,0,135,104,36,37,319
2712,7,2,0,135,103,36,37,320
2713,7,0,0,134,103,37,37,318
2714,7,0,0,134,104,38,38,321
2715,7,0,0,133,104,37,38,319
2716,7,0,0,132,103,36,37,315
2717,7,1,0,132,103,36,37,316
2718,7,1,0,132,103,36,37,316
2719,7,0,0,130,103,37,38,315
2720,7,1,0,127,103,35,37,310
2721,6,0,0,125,103,38,37,309
2722,7,0,0,124,104,37,38,310
2723,7,0,0,123,104,37,38,309
2724,7,0,0,0,103,37,38,185
2725,7,0,0,0,103,36,37,183
2726,7,0,0,0,104,37,37,185
2727,7,0,0,0,103,37,37,184
2728,7,0,0,0,104,37,37,185
2729,7,1,0,1,104,38,38,189
2730,7,0,0,0,104,37,37,185
2731,6,0,0,0,104,36,37,183
2732,7,0,0,0,104,37,38,186
2733,7,0,0,0,105,38,37,187
2734,7,1,0,0,105,37,37,187
2735,7,1,0,0,104,38,38,188
2736,6,0,0,1,104,38,38,187
2737,7,0,0,0,103,37,38,185
2738,7,1,0,0,104,36,38,186
2739,7,0,0,1,103,37,38,186
2740,7,0,0,0,104,36,37,184
2741,6,0,0,0,104,37,37,184
2742,7,0,0,0,104,37,37,185
2743,7,1,0,1,104,38,38,189
2744,7,1,0,0,104,35,38,185
2745,6,0,0,0,104,37,37,184
2746,7,1,0,0,104,37,38,187
2747,7,0,0,0,104,37,38,186
2748,7,1,0,0,104,35,37,184
2749,7,0,0,1,104,38,38,188
2750,6,0,0,0,104,38,38,186
2751,7,0,0,0,104,37,38,186
2752,7,0,0,0,104,37,38,186
2753,7,0,0,143,112,1457,38,1757
2754,7,0,0,128,110,1620,37,1902
2755,7,0,0,127,111,1714,37,1996
2756,7,1,0,126,111,1749,38,2032
2757,7,0,0,126,112,1769,38,2052
2758,7,1,0,124,111,1790,38,2071
2759,6,0,0,123,113,1793,37,2072
2760,7,0,0,123,114,1793,38,2075
2761,7,0,0,122,111,1799,38,2077
2762,7,0,0,0,113,1803,37,1960
2763,7,0,0,0,114,1811,37,1969
2764,7,1,0,1,114,1821,37,1981
2765,7,0,0,0,114,1803,38,1962
2766,7,0,0,0,114,1817,38,1976
2767,7,2,0,0,114,1811,37,1971
2768,7,0,0,0,114,1819,38,1978
2769,7,0,0,0,115,1823,38,1983
2770,7,0,0,0,104,1,38,150
2771,7,0,0,0,105,1,37,150
2772,7,0,0,0,105,1,37,150
2773,6,0,0,0,103,0,37,146
2774,7,1,0,0,104,1,38,151
2775,7,0,0,0,103,1,38,149
2776,6,0,0,0,103,1,38,148
2777,7,0,0,0,103,1,38,149
2778,6,1,0,0,103,0,38,148
2779,6,0,0,0,103,1,38,148
2780,7,0,0,10,103,1,38,159
2781,7,0,0,0,103,1,39,150
2782,7,0,0,0,103,1,37,148
2783,7,1,0,0,104,1,38,151
2784,7,0,0,0,103,1,38,149
2785,7,0,0,0,105,1,37,150
2786,7,0,0,0,104,0,37,148
2787,7,0,0,0,104,0,37,148
2788,7,0,0,0,104,1,38,150
2789,7,0,0,151,104,1,38,301
2790,7,1,0,136,104,39,37,324
2791,7,1,0,129,103,38,37,315
2792,7,2,0,127,104,37,37,314
2793,7,0,0,126,104,37,38,312
2794,7,0,0,124,104,36,38,309
2795,6,0,0,123,104,36,37,306
2796,7,1,0,124,104,36,38,310
2797,7,0,0,122,103,37,37,306
2798,7,0,0,0,104,36,38,185
2799,7,1,0,0,103,36,37,184
2800,7,0,0,0,104,36,37,184
2801,7,0,0,0,104,37,38,186
2802,7,0,0,0,104,37,37,185
2803,6,0,0,0,103,37,38,184
2804,7,0,0,0,104,38,38,187
2805,7,1,0,0,104,37,37,186
2806,7,0,0,0,104,37,37,185
2807,7,0,0,0,104,36,37,184
2808,7,1,0,0,103,35,37,183
2809,7,0,0,0,103,37,38,185
2810,6,0,0,1,103,36,38,184
2811,7,0,0,0,103,36,38,184
2812,6,1,0,1,103,37,38,186
2813,7,0,0,0,103,36,38,184
2814,7,1,0,0,104,37,37,186
2815,7,0,0,0,105,36,37,185
2816,7,0,0,0,104,38,37,186
2817,7,0,0,1,104,36,37,185
2818,7,2,0,0,103,37,37,186
2819,6,1,0,0,103,37,38,185
2820,6,1,0,0,103,37,38,185
2821,7,1,0,0,103,37,37,185
2822,6,0,0,0,104,36,37,183
2823,6,0,0,1,103,37,38,185
2824,7,0,0,0,104,36,37,184
2825,7,0,0,0,103,36,37,183
2826,6,0,0,0,104,37,38,185
2827,7,2,0,0,103,38,37,187
2828,7,1,0,0,104,37,37,186
2829,6,0,0,148,103,37,38,332
2830,6,1,0,136,103,37,38,321
2831,7,0,0,129,103,36,38,313
2832,7,0,0,127,103,38,37,312
2833,7,0,0,126,104,37,37,311
2834,334,0,0,125,103,36,37,635
2835,333,0,0,124,104,36,178,775
2836,331,0,0,123,103,37,264,858
2837,330,0,0,122,104,38,266,860
2838,331,0,0,0,104,36,294,765
2839,331,1,0,0,103,36,354,825
2840,332,0,0,10,105,37,416,900
2841,332,0,0,10,104,36,264,746
2842,331,1,0,0,104,36,262,734
2843,333,1,0,0,104,36,240,714
2844,332,0,0,0,103,35,285,755
2845,333,1,0,0,103,36,286,759
2846,332,1,0,0,103,36,276,748
2847,332,0,0,0,103,36,292,763
2848,331,0,0,0,103,34,286,754
2849,332,0,0,0,103,36,289,760
2850,331,0,0,0,103,36,296,766
2851,331,0,0,0,104,36,254,725
2852,332,0,0,0,104,36,288,760
2853,330,1,0,0,103,36,288,758
2854,330,0,0,0,103,36,281,750
2855,330,1,0,0,104,36,281,752
2856,330,1,0,0,111,1495,287,2224
2857,329,0,0,0,110,1640,290,2369
2858,329,1,0,0,111,1720,292,2453
2859,329,0,0,0,113,1746,292,2480
2860,329,1,0,0,113,1753,265,2461
2861,330,1,0,0,113,1766,270,2480
2862,329,0,0,0,114,1775,225,2443
2863,329,0,0,0,113,1790,223,2455
2864,326,0,0,10,113,1791,229,2469
2865,325,0,0,6,112,1800,222,2465
2866,324,0,0,147,113,1797,220,2601
2867,324,2,0,135,113,1805,265,2644
2868,326,1,0,132,113,1799,286,2657
2869,325,0,0,132,113,1805,269,2644
2870,326,0,0,131,113,1806,287,2663
2871,327,0,0,132,113,1808,291,2671
2872,327,0,0,130,107,1,265,830
2873,327,0,0,130,103,1,286,847
2874,326,1,0,130,103,0,221,781
2875,7,0,0,129,103,1,48,288
2876,7,0,0,128,103,1,48,287
2877,6,1,0,129,104,1,49,290
2878,7,1,0,130,103,1,48,290
2879,7,0,0,129,103,1,49,289
2880,7,1,0,7,102,1,48,166
2881,7,0,0,7,103,1,48,166
2882,7,0,0,7,102,1,48,165
2883,6,1,0,7,103,1,48,166
2884,6,2,0,7,103,1,48,167
2885,7,0,0,7,103,1,49,167
2886,6,0,0,7,103,1,48,165
2887,7,0,0,7,103,1,49,167
2888,6,0,0,7,103,1,49,166
2889,7,1,0,149,103,0,49,309
2890,7,1,0,141,103,39,49,340
2891,7,0,0,134,103,37,49,330
2892,7,1,0,135,103,37,48,331
2893,7,0,0,135,104,38,48,332
2894,7,0,0,132,103,36,49,327
2895,7,0,0,129,104,36,49,325
2896,7,1,0,127,104,36,49,324
2897,7,0,0,127,103,37,49,323
2898,7,0,0,124,104,36,49,320
2899,7,0,0,124,104,37,48,320
2900,6,0,0,123,103,37,49,318
2901,7,0,0,0,104,36,49,196
2902,7,0,0,0,104,36,48,195
2903,7,1,0,0,104,37,49,198
2904,6,0,0,0,104,36,49,195
2905,7,1,0,0,103,36,49,196
2906,7,0,0,1,104,36,49,197
2907,7,0,0,0,104,36,49,196
2908,6,0,0,0,104,37,48,195
2909,7,0,0,0,103,36,49,195
2910,7,0,0,0,104,36,49,196
2911,7,0,0,0,104,36,38,185
2912,7,0,0,0,103,36,38,184
2913,7,1,0,0,104,38,39,189
2914,7,0,0,0,104,36,38,185
2915,6,0,0,0,103,36,38,183
2916,7,0,0,0,103,37,39,186
2917,6,0,0,0,104,38,38,186
2918,6,0,0,0,103,35,38,182
2919,6,2,0,0,104,36,38,186
2920,6,0,0,0,104,35,38,183
2921,7,0,0,0,103,37,38,185
2922,7,2,0,0,103,36,38,186
2923,6,0,0,0,103,37,38,184
2924,6,0,0,0,103,36,38,183
2925,7,0,0,0,103,36,38,184
2926,6,1,0,0,104,36,38,185
2927,6,0,0,0,103,37,39,185
2928,6,1,0,0,103,36,38,184
2929,7,1,0,0,104,36,39,187
2930,7,1,0,0,103,36,38,185
2931,7,1,0,143,103,35,38,327
2932,6,0,0,138,103,37,38,322
2933,7,0,0,127,104,36,38,312
2934,7,0,0,126,103,36,38,310
2935,7,0,0,126,103,35,38,309
2936,6,0,0,125,103,37,38,309
2937,7,0,0,124,103,37,38,309
2938,7,0,0,123,103,36,38,307
2939,7,0,0,122,104,36,39,308
2940,7,0,0,0,103,36,39,185
2941,6,0,0,0,104,36,39,185
2942,6,1,0,0,103,36,38,184
2943,6,0,0,0,103,37,39,185
2944,7,1,0,0,104,36,38,186
2945,6,0,0,0,104,36,38,184
2946,6,0,0,0,102,36,38,182
2947,7,0,0,0,103,36,38,184
2948,6,2,0,0,103,36,38,185
2949,6,0,0,0,103,36,39,184
2950,7,0,0,0,103,36,38,184
2951,6,0,0,1,103,36,38,184
2952,6,0,0,1,104,36,38,185
2953,6,1,0,0,103,37,38,185
2954,7,0,0,7,103,35,38,190
2955,7,0,0,0,103,36,38,184
2956,7,0,0,0,103,37,39,186
2957,7,1,0,0,111,1277,38,1434
2958,7,1,0,0,113,1573,39,1733
2959,7,0,0,0,112,1685,38,1842
2960,7,0,0,0,113,1725,38,1883
2961,7,0,0,0,113,1735,38,1893
2962,7,0,0,0,113,1749,38,1907
2963,7,0,0,0,114,1763,38,1922
2964,7,0,0,0,114,1771,39,1931
2965,6,0,0,0,114,1782,39,1941
2966,7,0,0,0,114,1789,38,1948
2967,6,0,0,0,115,1797,39,1957
2968,6,0,0,140,113,1799,38,2096
2969,7,0,0,128,114,1801,38,2088
2970,7,1,0,126,114,1805,39,2092
2971,7,0,0,126,107,1,38,279
2972,7,0,0,125,106,1,38,277
2973,7,0,0,124,104,1,38,274
2974,7,0,0,123,103,1,38,272
2975,7,0,0,123,105,1,39,275
2976,7,1,0,0,104,1,38,151
2977,7,0,0,0,103,1,38,149
2978,7,0,0,0,105,1,38,151
2979,6,0,0,0,103,1,38,148
2980,7,1,0,0,105,1,38,152
2981,6,0,0,1,104,0,39,150
2982,6,1,0,0,104,1,38,150
2983,7,0,0,0,103,1,39,150
2984,7,0,0,0,103,1,38,149
2985,7,1,0,0,104,0,38,150
2986,7,1,0,0,103,1,38,150
2987,6,0,0,0,102,1,38,147
2988,7,2,0,0,103,38,38,188
2989,6,1,0,0,105,37,38,187
2990,6,0,0,0,103,36,39,184
2991,6,1,0,0,103,36,39,185
2992,7,1,0,0,104,36,39,187
2993,7,0,0,0,103,35,38,183
2994,7,0,0,1,103,36,38,185
2995,7,6,0,1,103,36,39,192
2996,7,4,0,0,103,37,39,190
2997,7,7,0,0,103,35,39,191
2998,6,7,0,1,104,37,39,194
2999,6,10,0,0,104,36,38,194
3000,7,5,0,0,103,35,38,188
3001,7,11,0,0,104,36,38,196
3002,7,5,0,0,105,36,38,191
3003,7,7,0,1,104,35,38,192
3004,7,5,0,0,104,37,38,191
3005,6,10,0,1,104,37,39,197
3006,7,10,0,1,103,36,38,195
3007,6,4494,0,0,103,35,39,4677
3008,6,4505,0,141,104,37,39,4832
3009,6,4497,0,129,103,36,39,4810
3010,6,4470,0,127,104,35,39,4781
3011,7,4469,0,126,104,36,38,4780
3012,6,4447,0,125,103,35,39,4755
3013,6,4447,0,124,103,35,38,4753
3014,7,4490,0,123,103,36,38,4797
3015,7,4461,0,127,103,36,38,4772
3016,6,4457,0,124,104,36,39,4766
3017,7,4454,0,1,103,36,38,4639
3018,6,4487,0,0,103,36,38,4670
3019,7,4497,0,1,103,36,39,4683
3020,6,4480,0,0,104,35,39,4664
3021,7,4466,0,1,103,35,38,4650
3022,7,4453,0,0,104,35,39,4638
3023,6,236,0,0,104,36,38,420
3024,7,241,0,0,103,36,38,425
3025,6,4461,0,1,104,36,39,4647
3026,6,4464,0,0,103,36,38,4647
3027,7,231,0,0,103,36,39,416
3028,7,228,0,0,104,37,38,414
3029,6,236,0,0,104,36,38,420
3030,7,4455,0,1,104,36,38,4641
3031,6,4460,0,0,103,34,38,4641
3032,7,234,0,0,103,36,39,419
3033,6,230,0,1,103,35,39,414
3034,6,233,0,1,103,37,38,418
3035,7,236,0,0,104,36,38,421
3036,6,238,0,0,104,36,39,423
3037,6,241,0,0,104,36,38,425
3038,7,242,0,0,104,36,38,427
3039,7,244,0,79,103,36,39,508
3040,6,243,0,7,103,37,38,434
3041,6,242,0,7,104,36,38,433
3042,7,0,0,7,103,35,38,190
3043,6,0,0,7,104,37,38,192
3044,7,0,0,149,104,35,39,334
3045,7,0,0,138,104,35,38,322
3046,6,2,0,138,103,35,39,323
3047,6,1,0,136,102,36,38,319
3048,7,0,0,136,102,37,38,320
3049,6,1,0,134,104,36,38,319
3050,6,0,0,133,104,36,38,317
3051,7,1,0,132,103,35,39,317
3052,7,1,0,132,103,36,39,318
3053,7,0,0,131,104,36,39,317
3054,7,1,0,131,104,36,39,318
3055,7,0,0,131,103,36,39,316
3056,7,0,0,131,103,36,38,315
3057,7,1,0,129,103,36,38,314
3058,6,1,0,129,104,36,38,314
3059,7,0,0,129,103,36,38,313
3060,6,1,0,129,104,35,39,314
3061,7,0,0,7,103,35,38,190
3062,6,1,0,7,103,37,39,193
3063,7,0,0,7,103,35,38,190
3064,7,0,0,7,103,36,39,192
3065,6,0,0,7,103,34,39,189
3066,7,0,0,7,103,36,39,192
3067,7,0,0,7,103,36,38,191
3068,7,0,0,7,104,35,38,191
3069,7,0,0,7,103,36,38,191
3070,7,0,0,158,104,36,38,343
3071,6,0,0,139,103,36,38,322
3072,7,0,0,136,104,36,38,321
3073,7,1,0,134,103,36,38,319
3074,7,1,0,134,103,37,39,321
3075,6,0,0,133,104,35,39,317
3076,7,0,0,132,105,36,39,319
3077,6,1,0,131,103,36,39,316
3078,6,0,0,127,104,36,39,312
3079,7,0,0,126,103,36,39,311
3080,7,6,0,125,103,37,39,317
3081,7,0,0,124,103,35,39,308
3082,295,0,0,122,104,37,39,597
3083,6,0,0,0,103,36,38,183
3084,7,0,0,0,103,36,38,184
3085,7,0,0,0,103,36,39,185
3086,7,0,0,0,103,36,38,184
3087,7,0,0,0,104,37,39,187
3088,7,0,0,0,103,36,39,185
3089,7,0,0,0,104,37,38,186
3090,7,0,0,0,103,36,38,184
3091,7,0,0,0,104,37,39,187
3092,7,0,0,0,103,37,39,186
3093,7,0,0,1,103,35,39,185
3094,7,0,0,1,104,36,39,187
3095,6,0,0,0,103,36,38,183
3096,7,0,0,0,103,37,38,185
3097,6,1,0,0,104,35,38,184
3098,7,1,0,0,103,36,38,185
3099,6,0,0,0,103,35,38,182
3100,7,0,0,0,104,35,39,185
3101,7,1,0,0,104,36,39,187
3102,7,0,0,0,104,36,39,186
3103,6,0,0,0,103,36,38,183
3104,7,1,0,0,104,37,38,187
3105,6,1,0,0,104,35,39,185
3106,7,0,0,0,104,36,38,185
3107,6,1,0,0,103,36,38,184
3108,7,0,0,0,104,35,38,184
3109,7,0,0,0,104,36,38,185
3110,7,0,0,0,104,36,39,186
3111,7,0,0,0,103,36,38,184
3112,6,0,0,143,103,35,38,325
3113,6,0,0,129,104,36,38,313
3114,6,0,0,126,103,36,38,309
3115,7,0,0,127,103,35,39,311
3116,7,0,0,125,103,36,39,310
3117,7,0,0,124,104,36,38,309
3118,6,1,0,124,104,36,39,310
3119,7,0,0,122,103,37,39,308
3120,7,0,0,122,103,37,39,308
3121,7,0,0,1,103,36,38,185
3122,7,0,0,0,104,38,38,187
3123,6,0,0,0,104,36,39,185
3124,6,0,0,0,104,36,38,184
3125,7,1,0,1,104,35,39,187
3126,7,0,0,0,104,37,39,187
3127,7,1,0,0,104,36,39,187
3128,7,0,0,0,103,37,39,186
3129,7,0,0,0,104,36,37,184
3130,7,0,0,0,103,36,39,185
3131,7,0,0,0,103,37,38,185
3132,7,1,0,0,104,37,39,188
3133,7,0,0,0,104,37,38,186
3134,7,0,0,0,103,36,39,185
3135,7,0,0,1,104,36,38,186
3136,7,1,0,0,103,36,39,186
3137,7,0,0,10,104,37,39,197
3138,7,0,0,0,104,36,38,185
3139,7,0,0,0,104,35,39,185
3140,6,0,0,0,104,36,38,184
3141,7,0,0,0,104,36,39,186
3142,6,0,0,0,104,37,38,185
3143,7,1,0,0,103,35,38,184
3144,7,1,0,1,103,36,38,186
3145,7,1,0,1,103,35,38,185
3146,6,0,0,0,103,36,38,183
3147,6,0,0,0,103,36,38,183
3148,7,0,0,146,103,36,38,330
3149,6,0,0,131,104,36,39,316
3150,7,0,0,127,104,36,39,313
3151,7,0,0,127,103,36,38,311
3152,7,0,0,125,103,37,38,310
3153,7,0,0,124,103,37,38,309
3154,7,0,0,124,103,36,38,308
3155,7,0,0,122,103,37,38,307
3156,7,1,0,122,103,37,38,308
3157,7,0,0,0,104,36,39,186
3158,6,1,0,0,104,36,38,185
3159,6,0,0,0,104,36,39,185
3160,7,1,0,0,104,37,39,188
3161,7,0,0,0,103,35,38,183
3162,7,0,0,0,103,37,38,185
3163,7,0,0,0,104,35,39,185
3164,6,0,0,0,104,36,39,185
3165,7,0,0,0,103,36,39,185
3166,6,0,0,0,104,36,39,185
3167,7,0,0,0,103,36,38,184
3168,7,0,0,1,103,37,39,187
3169,7,0,0,0,103,36,39,185
3170,7,0,0,0,104,36,39,186
3171,7,0,0,0,104,36,38,185
3172,7,0,0,0,104,36,38,185
3173,6,1,0,0,104,36,38,185
3174,7,0,0,0,104,36,38,185
3175,7,0,0,1,103,37,38,186
3176,7,1,0,0,104,36,39,187
3177,7,0,0,0,104,36,39,186
3178,7,0,0,0,104,36,39,186
3179,333,0,0,0,103,36,39,511
3180,330,0,0,0,104,35,217,686
3181,331,0,0,0,105,36,308,780
3182,331,1,0,0,104,35,229,700
3183,330,1,0,0,104,36,263,734
3184,334,0,0,0,104,36,316,790
3185,332,0,0,0,105,36,228,701
3186,331,0,0,0,104,36,215,686
3187,332,0,0,0,113,1519,312,2276
3188,331,0,0,0,113,1656,363,2463
3189,334,1,0,140,115,1727,324,2641
3190,331,0,0,138,114,1721,388,2692
3191,331,0,0,128,114,1745,221,2539
3192,335,0,0,127,114,1753,343,2672
3193,329,0,0,126,114,1769,226,2564
3194,334,0,0,126,114,1775,321,2670
3195,332,0,0,124,114,1778,251,2599
3196,331,0,0,123,115,1786,385,2740
3197,334,1,0,127,113,1783,221,2579
3198,331,0,0,10,114,1789,377,2621
3199,335,1,0,0,114,1789,228,2467
3200,333,0,0,0,114,1792,231,2470
3201,334,1,0,0,114,1795,258,2502
3202,337,0,0,0,115,1798,268,2518
3203,334,0,0,0,107,1,346,788
3204,332,0,0,0,106,0,358,796
3205,329,0,0,0,106,1,311,747
3206,330,0,0,0,106,0,249,685
3207,330,0,0,0,106,1,237,674
3208,334,0,0,0,104,1,239,678
3209,337,0,0,0,105,0,311,753
3210,334,0,0,0,104,0,254,692
3211,336,0,0,0,105,0,284,725
3212,334,0,0,0,104,1,212,651
3213,334,0,0,0,104,0,205,643
3214,337,0,0,0,104,0,363,804
3215,335,0,0,0,105,1,215,656
3216,339,0,0,0,106,1,247,693
3217,334,1,0,0,104,0,246,685
3218,335,0,0,0,104,1,222,662
3219,334,0,0,0,106,0,261,701
3220,332,1,0,0,104,0,198,635
3221,334,0,0,0,104,39,222,699
3222,335,0,0,0,104,38,213,690
3223,335,0,0,0,104,37,163,639
3224,335,0,0,10,104,37,376,862
3225,333,0,0,7,104,37,381,862
3226,7,0,0,152,104,38,38,339
3227,7,0,0,138,104,36,37,322
3228,7,1,0,135,114,1497,38,1792
3229,7,0,0,135,115,1682,37,1976
3230,7,0,0,133,115,1768,38,2061
3231,6,0,0,132,114,1747,39,2038
3232,7,0,0,132,114,1760,39,2052
3233,7,0,0,131,114,1774,39,2065
3234,7,1,0,131,116,1774,38,2067
3235,7,0,0,130,114,1783,38,2072
3236,7,1,0,130,115,1787,38,2078
3237,7,0,0,130,115,1794,38,2084
3238,7,0,0,130,115,1799,39,2090
3239,7,0,0,130,115,1798,38,2088
3240,7,1,0,129,114,1810,39,2100
3241,7,0,0,7,115,1815,38,1982
3242,7,0,0,7,114,1834,39,2001
3243,7,1,0,7,106,1,39,161
3244,7,0,0,7,107,1,39,161
3245,7,1,0,7,106,1,38,160
3246,7,1,0,7,106,1,38,160
3247,7,0,0,7,105,1,39,159
3248,7,0,0,7,104,1,38,157
3249,7,0,0,7,106,1,38,159
3250,7,0,0,156,105,1,38,307
3251,7,0,0,140,104,1,39,291
3252,7,1,0,134,105,1,39,287
3253,7,0,0,132,104,1,38,282
3254,7,0,0,132,104,1,39,283
3255,337,0,0,130,105,1,247,820
3256,338,0,0,127,104,0,221,790
3257,337,0,0,125,103,0,227,792
3258,337,0,0,125,104,1,227,794
3259,337,0,0,125,104,1,226,793
3260,337,0,0,122,105,1,290,855
3261,338,0,0,0,106,38,225,707
3262,338,0,0,0,105,38,263,744
3263,338,1,0,0,105,38,231,713
3264,339,1,0,0,106,37,261,744
3265,339,1,0,0,105,38,280,763
3266,340,1,0,0,104,38,259,742
3267,341,1,0,0,104,37,338,821
3268,343,1,0,0,105,38,271,758
3269,337,0,0,0,104,36,225,702
3270,335,1,0,0,105,37,263,741
3271,334,0,0,0,105,37,224,700
3272,334,0,0,0,105,36,370,845
3273,334,0,0,0,104,36,242,716
3274,332,0,0,0,105,36,231,704
3275,332,0,0,0,104,36,238,710
3276,335,1,0,0,106,36,243,721
3277,332,1,0,0,106,36,259,734
3278,332,0,0,0,105,35,245,717
3279,335,0,0,0,104,37,247,723
3280,333,0,0,0,106,37,227,703
3281,336,1,0,0,104,38,240,719
3282,330,0,0,0,104,37,344,815
3283,329,1,0,0,105,36,233,704
3284,330,0,0,0,104,36,232,702
3285,330,0,0,0,105,36,251,722
3286,332,0,0,0,104,36,265,737
3287,333,0,0,0,104,36,254,727
3288,333,0,0,0,104,35,243,715
3289,333,0,0,0,105,36,323,797
3290,334,1,0,620,103,35,257,1350
3291,336,0,0,141,105,36,293,911
3292,333,0,0,128,113,1262,233,2069
3293,332,1,0,127,114,1570,363,2507
3294,333,0,0,127,114,1717,234,2525
3295,7,0,0,125,114,1726,37,2009
3296,7,1,0,126,114,1741,38,2027
3297,7,1,0,123,114,1758,38,2041
3298,7,0,0,124,115,1770,38,2054
3299,7,0,0,111,115,1777,38,2048
3300,7,2,0,0,116,1785,37,1947
3301,7,0,0,0,114,1793,37,1951
3302,6,1,0,0,114,1794,37,1952
3303,7,1,0,0,114,1799,38,1959
3304,6,1,0,0,114,1803,37,1961
3305,6,0,0,0,114,1807,39,1966
3306,7,1,0,0,114,1803,39,1964
3307,7,0,0,0,115,1808,39,1969
3308,7,0,0,0,114,1814,38,1973
3309,7,0,0,0,114,1808,38,1967
3310,6,0,0,0,108,1,38,153
3311,7,0,0,11,107,1,38,164
3312,7,0,0,10,108,1,38,164
3313,6,1,0,0,106,1,38,152
3314,7,0,0,1,106,1,39,154
3315,7,0,0,0,106,1,39,153
3316,7,0,0,0,106,0,38,151
3317,7,0,0,0,106,1,38,152
3318,6,1,0,0,107,1,39,154
3319,7,1,0,0,106,1,38,153
3320,7,0,0,0,105,1,38,151
3321,7,0,0,0,105,1,39,152
3322,7,0,0,0,105,1,38,151
3323,7,0,0,1,104,1,39,152
3324,7,0,0,0,104,1,39,151
3325,7,0,0,1,103,1,39,151
3326,7,0,0,0,106,0,38,151
3327,7,0,0,142,103,38,39,329
3328,7,0,0,131,104,38,38,318
3329,6,0,0,127,105,38,40,316
3330,7,0,0,127,105,37,38,314
3331,7,0,0,126,105,36,38,312
3332,7,1,0,126,104,38,39,315
3333,7,1,0,126,106,38,38,316
3334,7,1,0,122,104,37,38,309
3335,7,0,0,0,105,36,39,187
3336,7,0,0,0,106,37,39,189
3337,7,1,0,0,107,38,38,191
3338,7,0,0,0,105,37,38,187
3339,6,0,0,0,105,38,38,187
3340,7,1,0,0,107,36,38,189
3341,7,1,0,1,103,38,39,189
3342,7,2,0,0,104,37,39,189
3343,7,0,0,0,105,37,39,188
3344,7,0,0,0,104,37,38,186
3345,7,0,0,0,106,36,38,187
3346,7,1,0,0,115,1478,38,1639
3347,7,0,0,1,114,1651,39,1812
3348,7,0,0,0,114,1755,39,1915
3349,6,1,0,0,114,1750,39,1910
3350,7,1,0,0,114,1761,38,1921
3351,7,1,0,0,114,1769,39,1930
3352,7,0,0,0,114,1786,39,1946
3353,7,1,0,0,115,1787,39,1949
3354,7,0,0,0,115,1797,38,1957
3355,7,0,0,0,114,1800,39,1960
3356,6,0,0,0,115,1808,39,1968
3357,7,0,0,0,115,1810,39,1971
3358,7,0,0,0,115,1813,39,1974
3359,7,1,0,0,114,1816,39,1977
3360,7,1,0,0,115,1811,38,1972
3361,7,0,0,0,114,1816,39,1976
3362,7,1,0,0,113,1821,38,1980
3363,6,0,0,0,114,1819,39,1978
3364,7,0,0,0,108,1,38,154
3365,7,0,0,0,108,1,38,154
3366,7,0,0,0,106,1,38,152
3367,7,1,0,148,107,1,39,303
3368,7,0,0,136,106,1,38,288
3369,7,0,0,128,106,1,38,280
3370,7,1,0,127,106,1,38,280
3371,7,0,0,127,106,0,38,278
3372,7,0,0,130,106,1,39,283
3373,7,1,0,127,105,1,39,280
3374,7,1,0,125,106,1,38,278
3375,7,1,0,124,106,1,38,277
3376,6,0,0,0,106,1,38,151
3377,7,0,0,0,104,1,39,151
3378,7,0,0,0,105,1,39,152
3379,7,0,0,0,106,1,39,153
3380,7,0,0,0,104,39,39,189
3381,7,1,0,0,106,38,39,191
3382,7,1,0,0,106,38,38,190
3383,7,0,0,0,106,38,39,190
3384,7,1,0,0,105,37,39,189
3385,7,0,0,0,104,38,39,188
3386,6,0,0,0,105,37,39,187
3387,7,0,0,0,106,38,38,189
3388,7,0,0,1,105,37,39,189
3389,7,2,0,0,105,38,39,191
3390,7,1,0,0,106,37,39,190
3391,7,0,0,0,107,37,38,189
3392,7,1,0,0,107,38,39,192
3393,7,0,0,0,106,36,38,187
3394,7,0,0,1,107,37,38,190
3395,7,0,0,10,106,38,38,199
3396,7,1,0,7,105,37,39,196
3397,7,0,0,7,107,37,38,196
3398,7,0,0,7,105,38,39,196
3399,7,0,0,7,106,37,38,195
3400,7,0,0,7,108,37,38,197
3401,7,1,0,147,106,37,38,336
3402,7,0,0,137,107,38,38,327
3403,7,1,0,136,106,37,38,325
3404,7,0,0,135,106,37,39,324
3405,7,0,0,134,106,37,39,323
3406,7,0,0,133,115,1024,38,1317
3407,7,0,0,132,115,1572,38,1864
3408,7,0,0,132,115,1696,39,1989
3409,7,0,0,132,114,1728,39,2020
3410,7,0,0,131,114,1749,39,2040
3411,7,0,0,131,115,1767,39,2059
3412,7,0,0,131,115,1770,39,2062
3413,7,0,0,130,114,1783,39,2073
3414,7,1,0,130,115,1789,39,2081
3415,7,0,0,130,114,1797,38,2086
3416,7,0,0,129,114,1799,38,2087
3417,7,0,0,7,115,1805,38,1972
3418,7,0,0,7,115,1807,39,1975
3419,7,0,0,7,115,1807,38,1974
3420,7,1,0,7,114,1813,39,1981
3421,7,0,0,7,115,1811,39,1979
3422,7,0,0,7,114,1815,38,1981
3423,7,1,0,10,114,1821,38,1991
3424,6,0,0,0,114,1814,38,1972
3425,7,0,0,0,115,1822,38,1982
3426,7,0,0,148,107,1,39,302
3427,7,1,0,134,107,0,39,288
3428,7,0,0,132,107,1,39,286
3429,7,1,0,130,107,1,39,285
3430,7,0,0,128,107,1,38,281
3431,7,0,0,127,107,0,39,280
3432,7,0,0,127,107,1,39,281
3433,7,0,0,125,107,1,38,278
3434,7,0,0,124,107,1,38,277
3435,7,0,0,0,107,1,38,153
3436,7,1,0,0,107,1,38,154
3437,7,0,0,1,106,1,38,153
3438,7,0,0,0,106,1,39,153
3439,6,0,0,0,107,1,39,153
3440,7,0,0,0,107,1,40,155
3441,7,0,0,0,106,1,40,154
3442,7,1,0,0,106,1,39,154
3443,7,1,0,0,105,41,38,192
3444,7,0,0,0,106,38,38,189
3445,7,0,0,1,106,38,39,191
3446,7,0,0,0,106,38,39,190
3447,7,1,0,0,106,37,38,189
3448,7,1,0,0,106,37,38,189
3449,7,0,0,0,106,37,38,188
3450,7,0,0,1,108,37,38,191
3451,7,1,0,0,106,38,38,190
3452,7,0,0,0,106,37,39,189
3453,7,1,0,0,106,36,39,189
3454,7,0,0,0,107,37,39,190
3455,7,1,0,0,107,37,39,191
3456,7,0,0,0,108,37,39,191
3457,7,1,0,0,107,38,38,191
3458,7,0,0,0,106,37,38,188
3459,7,0,0,1,108,37,38,191
3460,7,0,0,0,107,37,39,190
3461,7,0,0,0,105,38,38,188
3462,7,0,0,0,108,37,39,191
3463,7,0,0,0,107,36,38,188
3464,7,0,0,1,106,38,38,190
3465,7,0,0,0,107,37,39,190
3466,7,0,0,148,107,38,39,339
3467,7,1,0,134,106,38,38,324
3468,7,0,0,128,106,37,39,317
3469,7,1,0,127,106,37,38,316
3470,7,0,0,126,106,37,39,315
3471,7,1,0,125,106,38,39,316
3472,7,0,0,124,106,36,38,311
3473,7,0,0,125,106,37,38,313
3474,7,1,0,123,106,36,38,311
3475,7,0,0,0,104,37,39,187
3476,7,0,0,0,106,37,39,189
3477,7,0,0,0,105,38,38,188
3478,7,2,0,0,106,37,39,191
3479,7,0,0,0,106,38,38,189
3480,7,0,0,0,105,38,38,188
3481,7,0,0,0,106,36,39,188
3482,7,0,0,0,106,36,38,187
3483,7,0,0,10,106,38,38,199
3484,7,0,0,7,105,38,38,195
3485,7,0,0,0,106,36,38,187
3486,6,0,0,0,106,37,39,188
3487,7,0,0,1,105,37,38,188
3488,7,0,0,1,105,38,38,189
3489,7,0,0,0,106,38,39,190
3490,7,1,0,1,106,37,38,190
3491,7,1,0,0,106,37,38,189
3492,7,0,0,0,106,36,38,187
3493,7,0,0,0,105,37,39,188
3494,7,0,0,1,105,38,39,190
3495,7,0,0,1,115,1386,38,1547
3496,7,0,0,0,115,1610,38,1770
3497,7,0,0,1,114,1733,38,1893
3498,7,0,0,0,114,1735,39,1895
3499,7,0,0,0,114,1745,38,1904
3500,7,1,0,0,115,1754,38,1915
3501,7,0,0,0,114,1763,38,1922
3502,7,0,0,0,115,1771,38,1931
3503,7,0,0,143,116,1789,38,2093
3504,7,0,0,131,115,1783,39,2075
3505,7,0,0,129,115,1794,38,2083
3506,7,0,0,128,115,1795,38,2083
3507,7,0,0,126,115,1802,38,2088
3508,7,1,0,126,114,1802,39,2089
3509,7,0,0,124,114,1803,39,2087
3510,7,1,0,123,114,1814,38,2097
3511,7,0,0,0,115,1809,38,1969
3512,7,1,0,0,114,1809,39,1970
3513,7,0,0,0,115,1813,39,1974
3514,6,1,0,0,115,1816,39,1977
3515,7,0,0,0,115,1818,39,1979
3516,7,0,0,0,115,1814,38,1974
3517,7,0,0,0,114,1823,38,1982
3518,7,0,0,0,115,1817,38,1977
3519,7,0,0,0,114,1818,39,1978
3520,7,0,0,0,108,1,39,155
3521,7,0,0,0,107,1,39,154
3522,7,0,0,0,108,1,38,154
3523,7,0,0,0,107,1,38,153
3524,7,1,0,0,107,1,38,154
3525,7,0,0,0,108,1,39,155
3526,7,0,0,0,107,1,38,153
3527,6,0,0,0,107,1,39,153
3528,7,1,0,0,107,1,38,154
3529,7,1,0,1,108,1,39,157
3530,7,2,0,0,107,1,38,155
3531,7,0,0,0,108,1,39,155
3532,7,0,0,0,107,1,38,153
3533,7,1,0,1,106,1,38,154
3534,7,0,0,0,107,1,39,154
3535,7,0,0,0,107,1,38,153
3536,7,0,0,1,106,1,38,153
3537,7,0,0,0,106,1,39,153
3538,7,0,0,1,107,39,39,193
3539,7,1,0,0,106,39,38,191
3540,7,0,0,0,106,39,39,191
3541,7,0,0,0,106,38,39,190
3542,7,0,0,0,107,37,38,189
3543,7,0,0,149,106,37,39,338
3544,6,1,0,138,106,37,38,326
3545,7,1,0,130,106,38,38,320
3546,7,0,0,130,107,37,39,320
3547,7,1,0,127,106,37,39,317
3548,7,0,0,126,107,38,39,317
3549,7,0,0,125,106,36,39,313
3550,7,1,0,125,106,38,39,316
3551,7,0,0,124,107,37,38,313
3552,7,1,0,0,107,37,39,191
3553,7,0,0,1,106,38,41,193
3554,6,1,0,0,106,38,39,190
3555,7,0,0,0,106,37,39,189
3556,7,0,0,0,107,36,38,188
3557,7,1,0,0,106,37,38,189
3558,7,0,0,1,106,38,38,190
3559,7,0,0,0,107,37,39,190
3560,7,0,0,0,107,38,39,191
3561,7,0,0,1,106,37,38,189
3562,7,0,0,0,107,37,38,189
3563,7,0,0,0,106,37,39,189
3564,7,0,0,0,107,38,39,191
3565,7,0,0,1,106,38,39,191
3566,7,0,0,0,106,36,38,187
3567,7,0,0,0,106,37,38,188
3568,7,0,0,0,107,38,39,191
3569,7,0,0,7,106,36,38,194
3570,7,1,0,7,106,38,39,198
3571,7,0,0,7,107,38,39,198
3572,7,0,0,7,106,37,38,195
3573,7,0,0,7,108,37,39,198
3574,6,0,0,7,106,37,38,194
3575,7,1,0,156,106,38,38,346
3576,7,0,0,140,107,37,38,329
3577,7,0,0,136,106,37,38,324
3578,6,1,0,135,106,38,39,325
3579,7,0,0,134,107,36,39,323
3580,7,0,0,134,114,1485,39,1779
3581,7,0,0,132,115,1654,39,1947
3582,7,0,0,132,115,1738,38,2030
3583,7,0,0,131,114,1737,39,2028
3584,7,0,0,132,114,1749,38,2040
3585,7,0,0,131,114,1753,39,2044
3586,7,0,0,130,115,1770,38,2060
3587,7,0,0,130,115,1775,39,2066
3588,7,0,0,130,115,1785,38,2075
3589,7,0,0,129,114,1787,38,2075
3590,6,0,0,129,114,1792,39,2080
3591,7,0,0,7,115,1799,39,1967
3592,7,0,0,7,115,1799,38,1966
3593,7,0,0,7,114,1803,39,1970
3594,7,1,0,7,114,1803,38,1970
3595,7,1,0,7,115,1807,39,1976
3596,6,0,0,7,114,1809,39,1975
3597,7,0,0,0,113,1813,38,1971
3598,7,0,0,0,114,1813,39,1973
3599,7,0,0,0,115,1813,38,1973
3600,7,0,0,0,115,1817,38,1977
3601,7,1,0,146,115,1818,39,2126
3602,7,0,0,132,114,1813,38,2104
3603,7,0,0,129,114,1817,38,2105
3604,7,1,0,127,114,1815,38,2102
3605,7,1,0,127,113,1816,38,2102
3606,7,0,0,125,114,1821,39,2106
3607,7,0,0,124,113,1817,39,2100
3608,7,0,0,123,114,1819,38,2101
3609,7,1,0,123,107,1,39,278
3610,7,0,0,0,107,0,40,154
3611,6,0,0,0,107,1,39,153
3612,7,1,0,0,107,1,39,155
3613,7,0,0,0,107,1,39,154
3614,7,1,0,0,106,0,39,153
3615,6,0,0,0,108,1,39,154
3616,7,0,0,0,108,1,39,155
3617,7,0,0,0,107,2,39,155
3618,7,0,0,0,106,1,38,152
3619,7,1,0,0,106,1,38,153
3620,7,1,0,1,108,1,38,156
3621,7,0,0,0,106,1,38,152
3622,7,0,0,0,107,1,39,154
3623,7,0,0,0,107,0,38,152
3624,7,0,0,0,107,0,39,153
3625,7,1,0,0,106,1,38,153
3626,7,0,0,1,106,38,38,190
3627,7,0,0,1,106,39,39,192
3628,7,0,0,1,106,39,38,191
3629,6,0,0,0,107,38,38,189
3630,7,0,0,0,107,38,38,190
3631,7,0,0,0,106,38,38,189
3632,7,0,0,0,106,38,38,189
3633,7,0,0,0,107,37,39,190
3634,6,0,0,0,106,38,38,188
3635,7,0,0,1,106,38,39,191
3636,7,0,0,1,106,37,39,190
3637,7,1,0,0,106,37,38,189
3638,6,0,0,0,106,37,38,187
3639,7,1,0,0,107,37,39,191
3640,7,0,0,0,107,37,39,190
3641,7,0,0,0,107,38,39,191
3642,7,0,0,143,107,37,39,333
3643,7,0,0,132,107,38,38,322
3644,7,0,0,129,107,37,39,319
3645,7,0,0,126,106,38,38,315
3646,7,0,0,127,107,38,38,317
3647,7,0,0,125,106,38,39,315
3648,7,0,0,124,107,37,39,314
3649,7,0,0,123,108,37,38,313
3650,7,0,0,124,107,38,38,314
3651,7,0,0,0,106,38,39,190
3652,6,0,0,0,107,38,39,190
3653,7,0,0,0,106,37,39,189
3654,7,0,0,0,115,1524,38,1684
3655,7,0,0,0,115,1677,38,1837
3656,7,0,0,0,114,1755,39,1915
3657,7,0,0,10,115,1779,38,1949
3658,6,0,0,0,115,1758,38,1917
3659,6,0,0,0,115,1762,38,1921
3660,6,0,0,0,114,1776,38,1934
3661,7,0,0,0,114,1779,39,1939
3662,6,0,0,1,114,1785,39,1945
3663,7,1,0,0,114,1797,38,1957
3664,7,0,0,0,113,1795,38,1953
3665,7,1,0,0,114,1801,40,1963
3666,7,1,0,0,114,1802,39,1963
3667,7,0,0,0,114,1805,39,1965
3668,7,1,0,0,114,1803,38,1963
3669,7,0,0,0,114,1815,38,1974
3670,7,0,0,0,113,1811,39,1970
3671,7,0,0,0,114,1815,39,1975
3672,6,0,0,0,113,1810,39,1968
3673,7,0,0,0,113,1814,39,1973
3674,7,0,0,0,115,1816,39,1977
3675,6,0,0,0,114,1817,38,1975
3676,7,0,0,0,114,1819,38,1978
3677,7,0,0,0,114,1818,38,1977
3678,7,0,0,141,115,1815,38,2116
3679,7,0,0,139,106,2,37,291
3680,7,2,0,129,107,1,38,284
3681,7,0,0,129,107,1,38,282
3682,6,1,0,127,107,1,38,280
3683,7,0,0,126,107,1,38,279
3684,7,0,0,124,106,0,38,275
3685,7,0,0,124,106,0,38,275
3686,7,1,0,122,106,0,38,274
3687,6,0,0,0,107,1,38,152
3688,6,0,0,0,107,1,38,152
3689,7,0,0,0,107,1,39,154
3690,7,0,0,0,107,1,39,154
3691,7,1,0,0,107,1,39,155
3692,7,0,0,0,107,1,39,154
3693,7,0,0,0,106,1,38,152
3694,6,0,0,0,107,1,39,153
3695,7,0,0,0,106,1,38,152
3696,7,0,0,0,107,38,39,191
3697,7,0,0,0,107,38,38,190
3698,6,0,0,0,107,36,39,188
3699,7,0,0,0,106,36,38,187
3700,7,0,0,0,106,37,38,188
3701,7,0,0,0,107,37,38,189
3702,6,0,0,0,106,36,38,186
3703,7,0,0,0,106,36,39,188
3704,7,0,0,0,106,36,38,187
3705,6,0,0,0,106,36,38,186
3706,6,0,0,0,106,36,39,187
3707,7,0,0,0,106,36,38,187
3708,7,0,0,0,106,36,38,187
3709,7,0,0,0,106,36,38,187
3710,6,0,0,0,105,36,39,186
3711,7,0,0,0,106,37,38,188
3712,7,0,0,0,106,36,38,187
3713,7,0,0,0,107,36,38,188
3714,7,0,0,0,107,37,39,190
3715,6,0,0,0,106,36,38,186
3716,7,1,0,0,106,36,38,188
3717,6,0,0,10,106,37,39,198
3718,7,0,0,10,106,37,38,198
3719,7,1,0,147,107,36,39,337
3720,7,0,0,132,107,35,39,320
3721,7,0,0,128,106,36,38,315
3722,7,1,0,127,106,36,39,316
3723,6,0,0,126,106,36,38,312
3724,7,1,0,126,107,36,38,315
3725,7,1,0,124,107,36,38,313
3726,7,0,0,124,106,36,39,312
3727,7,0,0,122,107,37,38,311
3728,7,0,0,0,107,36,38,188
3729,7,1,0,0,107,36,38,189
3730,7,0,0,0,107,37,38,189
3731,7,0,0,0,107,36,38,188
3732,6,0,0,0,106,37,39,188
3733,7,1,0,1,106,36,38,189
3734,7,1,0,0,106,37,38,189
3735,6,0,0,1,107,36,39,189
3736,7,0,0,0,107,36,38,188
3737,7,0,0,0,106,37,38,188
3738,7,1,0,0,106,36,38,188
3739,7,0,0,0,106,36,38,187
3740,6,0,0,0,106,36,39,187
3741,7,0,0,0,106,36,38,187
3742,7,0,0,1,108,36,39,191
3743,6,0,0,7,106,36,38,193
3744,7,0,0,7,114,1396,39,1563
3745,6,1,0,7,115,1613,38,1780
3746,7,0,0,7,115,1729,39,1897
3747,7,1,0,7,114,1734,38,1901
3748,6,0,0,7,114,1745,39,1911
3749,7,0,0,7,115,1749,39,1917
3750,7,0,0,149,114,1765,39,2074
3751,7,1,0,137,114,1770,38,2067
3752,7,0,0,135,114,1789,38,2083
3753,7,0,0,134,114,1793,38,2086
3754,7,1,0,134,114,1794,38,2088
3755,7,1,0,134,114,1807,39,2102
3756,6,0,0,132,113,1801,39,2091
3757,6,0,0,131,114,1810,38,2099
3758,7,0,0,131,114,1811,39,2102
3759,7,0,0,130,114,1819,38,2108
3760,7,0,0,130,114,1819,38,2108
3761,7,0,0,130,114,1827,38,2116
3762,7,1,0,129,114,1822,38,2111
3763,7,0,0,129,113,1826,38,2113
3764,6,0,0,129,115,1833,38,2121
3765,7,0,0,128,115,1822,38,2110
3766,7,0,0,7,107,1,38,160
3767,7,1,0,7,108,1,38,162
3768,6,1,0,7,106,1,39,160
3769,7,0,0,7,107,1,39,161
3770,7,0,0,7,106,1,38,159
3771,7,0,0,7,107,1,38,160
3772,6,0,0,0,107,0,38,151
3773,7,0,0,0,106,1,38,152
3774,7,1,0,0,107,1,38,154
3775,7,0,0,147,107,1,39,301
3776,6,0,0,141,106,1,39,293
3777,7,0,0,130,106,1,39,283
3778,7,0,0,128,106,1,39,281
3779,7,1,0,127,107,1,38,281
3780,7,0,0,125,108,1,38,279
3781,7,0,0,125,108,1,38,279
3782,6,0,0,124,106,37,38,311
3783,6,0,0,123,106,37,38,310
3784,6,0,0,122,107,38,39,312
3785,7,0,0,0,107,37,39,190
3786,7,1,0,0,106,36,38,188
3787,7,0,0,0,106,37,38,188
3788,7,1,0,0,106,37,38,189
3789,7,0,0,0,106,37,38,188
3790,7,0,0,0,106,38,39,190
3791,7,0,0,1,106,36,38,188
3792,7,0,0,1,106,36,38,188
3793,7,1,0,1,106,37,38,190
3794,7,0,0,1,106,37,38,189
3795,7,0,0,1,107,37,38,190
3796,7,0,0,1,106,36,38,188
3797,7,0,0,1,106,36,38,188
3798,7,0,0,0,106,37,38,188
3799,7,0,0,0,109,38,38,192
3800,7,0,0,1,108,38,38,192
3801,7,1,0,1,106,36,39,190
3802,6,0,0,0,106,37,38,187
3803,7,0,0,0,108,36,38,189
3804,6,1,0,0,107,37,38,189
3805,6,0,0,0,115,995,38,1154
3806,7,0,0,0,114,1566,38,1725
3807,7,0,0,0,114,1714,38,1873
3808,6,0,0,0,114,1768,38,1926
3809,7,0,0,0,114,1786,38,1945
3810,7,0,0,0,114,1794,38,1953
3811,7,0,0,0,115,1803,39,1964
3812,6,0,0,1,114,1778,38,1937
3813,7,1,0,0,115,1787,38,1948
3814,6,0,0,0,115,1787,39,1947
3815,7,0,0,0,114,1797,38,1956
3816,6,0,0,0,114,1798,38,1956
3817,7,0,0,145,114,1808,38,2112
3818,7,0,0,131,115,1807,38,2098
3819,6,1,0,127,114,1805,39,2092
3820,7,0,0,127,114,1810,38,2096
3821,7,0,0,125,114,1814,39,2099
3822,7,1,0,124,113,1816,39,2100
3823,6,0,0,123,114,1815,38,2096
3824,7,2,0,122,114,1821,39,2105
3825,7,0,0,122,114,1822,38,2103
3826,6,1,0,0,114,1824,38,1983
3827,7,0,0,0,114,1829,39,1989
3828,7,1,0,1,106,1,38,154
3829,7,0,0,0,106,1,39,153
3830,7,1,0,0,106,1,39,154
3831,7,0,0,7,107,1,38,160
3832,6,0,0,0,107,1,39,153
3833,7,0,0,0,108,1,39,155
3834,7,0,0,0,106,1,38,152
3835,7,0,0,0,108,1,39,155
3836,6,0,0,0,106,1,38,151
3837,6,0,0,0,107,1,38,152
3838,7,0,0,0,107,1,38,153
3839,6,0,0,0,106,1,39,152
3840,7,1,0,0,106,1,38,153
3841,7,1,0,0,106,39,38,191
3842,6,1,0,0,107,39,39,192
3843,7,0,0,0,107,38,38,190
3844,7,0,0,0,107,39,38,191
3845,7,0,0,0,107,39,38,191
3846,7,0,0,0,108,38,38,191
3847,7,0,0,0,107,37,38,189
3848,7,0,0,1,106,36,39,189
3849,7,0,0,0,107,36,38,188
3850,7,0,0,0,108,36,39,190
3851,6,0,0,0,107,36,38,187
3852,7,0,0,0,107,37,38,189
3853,7,1,0,1,106,36,39,190
3854,7,0,0,146,107,36,38,334
3855,7,1,0,134,107,36,38,323
3856,7,0,0,133,107,36,38,321
3857,7,0,0,134,106,36,38,321
3858,7,0,0,134,106,36,38,321
3859,7,1,0,133,107,36,38,322
3860,7,0,0,132,107,36,39,321
3861,7,0,0,131,106,36,39,319
3862,7,1,0,132,107,38,38,323
3863,7,0,0,131,108,35,38,319
3864,7,1,0,130,108,37,39,322
3865,7,0,0,130,107,36,38,318
3866,7,0,0,129,107,36,38,317
3867,7,0,0,129,107,37,38,318
3868,7,1,0,129,108,36,38,319
3869,7,0,0,7,108,36,39,197
3870,7,0,0,7,106,36,38,194
3871,7,2,0,7,107,38,39,200
3872,6,0,0,7,106,36,40,195
3873,7,0,0,7,107,37,39,197
3874,7,0,0,7,107,37,39,197
3875,7,0,0,7,107,36,39,196
3876,7,0,0,7,107,37,38,196
3877,7,0,0,7,108,36,39,197
3878,7,0,0,146,114,1166,39,1472
3879,6,0,0,135,114,1568,39,1862
3880,7,0,0,135,114,1717,39,2012
3881,7,1,0,134,115,1734,39,2030
3882,6,0,0,133,114,1751,38,2042
3883,7,1,0,130,113,1754,38,2043
3884,7,0,0,128,114,1767,38,2054
3885,7,0,0,127,114,1783,39,2070
3886,6,0,0,126,114,1790,39,2075
3887,7,0,0,125,115,1783,39,2069
3888,7,0,0,124,113,1789,39,2072
3889,7,0,0,122,114,1786,38,2067
3890,7,0,0,0,114,1797,39,1957
3891,7,0,0,0,114,1790,39,1950
3892,7,0,0,0,114,1799,38,1958
3893,7,0,0,0,114,1795,39,1955
3894,7,1,0,0,114,1802,39,1963
3895,7,0,0,0,114,1805,39,1965
3896,7,0,0,0,114,1807,39,1967
3897,7,1,0,0,108,1,38,155
3898,7,0,0,0,107,1,38,153
3899,7,0,0,0,107,0,38,152
3900,7,1,0,0,107,1,39,155
3901,7,1,0,0,107,1,38,154
3902,7,1,0,0,107,0,38,153
3903,7,0,0,0,107,1,39,154
3904,7,1,0,0,106,1,39,154
3905,7,1,0,0,106,1,38,153
3906,7,0,0,0,106,1,38,152
3907,7,0,0,1,106,1,38,153
3908,6,0,0,0,106,1,38,151
3909,7,1,0,0,106,36,38,188
3910,7,1,0,79,107,36,39,269
3911,7,0,0,0,106,37,38,188
3912,7,1,0,0,106,36,39,189
3913,7,1,0,0,106,37,39,190
3914,7,0,0,0,105,35,39,186
3915,7,0,0,0,106,36,39,188
3916,7,1,0,0,106,36,39,189
3917,6,1,0,0,106,36,39,188
3918,7,0,0,0,107,37,39,190
3919,6,0,0,0,105,36,38,185
3920,6,0,0,146,106,37,38,333
3921,7,1,0,134,106,36,39,323
3922,7,0,0,127,106,36,38,314
3923,7,0,0,126,105,36,38,312
3924,6,0,0,125,107,36,39,313
3925,6,0,0,125,106,36,39,312
3926,6,0,0,124,106,37,39,312
3927,6,0,0,123,106,37,38,310
3928,6,0,0,123,106,36,39,310
3929,7,0,0,0,106,37,39,189
3930,7,1,0,0,106,36,39,189
3931,7,0,0,0,108,37,39,191
3932,7,1,0,1,106,38,38,191
3933,7,0,0,0,106,35,38,186
3934,7,0,0,0,106,35,38,186
3935,7,0,0,0,107,36,38,188
3936,7,0,0,0,106,36,38,187
3937,6,0,0,0,106,35,38,185
3938,7,0,0,0,106,37,39,189
3939,7,0,0,0,106,36,39,188
3940,6,0,0,0,106,36,38,186
3941,6,0,0,1,107,36,38,188
3942,7,0,0,0,106,36,39,188
3943,6,0,0,10,106,36,38,196
3944,6,0,0,0,106,36,39,187
3945,7,0,0,0,108,36,39,190
3946,6,0,0,1,106,36,39,188
3947,7,0,0,0,105,36,38,186
3948,7,0,0,0,106,35,38,186
3949,7,0,0,0,106,35,38,186
3950,7,0,0,0,106,36,39,188
3951,6,0,0,0,106,36,38,186
3952,7,0,0,0,106,35,38,186
3953,7,0,0,0,106,36,38,187
3954,6,0,0,0,106,36,38,186
3955,7,0,0,148,106,36,38,335
3956,7,0,0,134,105,36,38,320
3957,6,1,0,127,106,36,39,315
3958,6,1,0,127,106,35,39,314
3959,6,0,0,125,106,37,39,313
3960,6,0,0,124,115,1426,38,1709
3961,7,0,0,123,113,1614,38,1895
3962,6,1,0,122,114,1704,38,1985
3963,7,0,0,121,114,1710,40,1992
3964,7,2,0,0,113,1725,39,1886
3965,7,0,0,0,113,1746,38,1904
3966,6,0,0,0,113,1753,39,1911
3967,7,0,0,1,113,1762,38,1921
3968,7,0,0,0,114,1769,38,1928
3969,6,1,0,0,113,1771,38,1929
3970,6,0,0,0,113,1782,39,1940
3971,7,0,0,0,113,1785,38,1943
3972,6,0,0,0,112,1785,38,1941
3973,7,1,0,0,113,1789,38,1948
3974,7,1,0,0,112,1798,38,1956
3975,7,0,0,0,114,1794,39,1954
3976,7,0,0,0,113,1803,38,1961
3977,7,1,0,0,113,1801,38,1960
3978,7,0,0,0,114,1803,38,1962
3979,7,0,0,1,114,1808,38,1968
3980,7,1,0,0,114,1808,38,1968
3981,6,1,0,0,107,1,39,154
3982,6,0,0,0,107,1,38,152
3983,7,0,0,0,108,1,38,154
3984,7,0,0,0,106,1,38,152
3985,7,0,0,0,106,1,38,152
3986,7,0,0,0,106,1,38,152
3987,7,0,0,0,106,1,38,152
3988,7,0,0,0,106,1,38,152
3989,7,0,0,0,106,1,38,152
3990,6,0,0,0,106,1,38,151
3991,7,0,0,0,106,1,39,153
3992,7,1,0,0,106,1,38,153
3993,7,0,0,0,106,1,39,153
3994,7,1,0,0,105,1,38,152
3995,7,0,0,0,106,1,39,153
3996,6,0,0,0,106,1,39,152
3997,7,0,0,141,106,39,38,331
3998,6,0,0,129,106,37,38,316
3999,7,0,0,127,105,36,39,314
4000,7,0,0,126,104,36,39,312
4001,7,0,0,126,106,35,40,314
4002,7,0,0,124,105,37,39,312
4003,7,1,0,127,105,36,38,314
4004,7,0,0,130,106,37,38,318
4005,7,0,0,129,106,37,38,317
4006,6,0,0,7,106,38,39,196
4007,7,0,0,7,105,36,38,193
4008,7,0,0,7,106,37,38,195
4009,7,0,0,7,106,37,39,196
4010,6,0,0,7,105,36,39,193
4011,6,0,0,7,104,37,38,192
4012,6,0,0,7,107,36,38,194
4013,6,0,0,7,106,36,38,193
4014,6,0,0,7,106,36,38,193
4015,7,0,0,152,106,37,39,341
4016,6,0,0,142,105,36,39,328
4017,6,0,0,136,106,36,38,322
4018,7,0,0,135,106,35,39,322
4019,7,1,0,134,106,36,38,322
4020,7,0,0,135,106,36,38,322
4021,7,0,0,133,106,36,39,321
4022,7,0,0,132,106,36,38,319
4023,7,0,0,133,106,37,38,321
4024,7,0,0,132,106,36,39,320
4025,7,0,0,130,106,36,38,317
4026,7,1,0,132,105,37,38,320
4027,7,0,0,131,105,37,38,318
4028,7,1,0,130,114,1381,38,1671
4029,7,1,0,129,113,1605,38,1893
4030,6,0,0,127,114,1714,38,1999
4031,6,0,0,129,114,1714,38,2001
4032,6,0,0,7,114,1728,39,1894
4033,7,1,0,10,115,1734,38,1905
4034,7,0,0,0,114,1752,39,1912
4035,7,0,0,0,114,1759,38,1918
4036,7,0,0,0,114,1768,38,1927
4037,6,1,0,0,114,1768,38,1927
4038,6,0,0,0,114,1779,39,1938
4039,7,0,0,0,113,1777,39,1936
4040,6,0,0,0,113,1776,39,1934
4041,7,0,0,0,114,1776,39,1936
4042,6,0,0,0,114,1786,38,1944
4043,6,0,0,0,113,1791,38,1948
4044,6,0,0,0,114,1785,39,1944
4045,7,1,0,147,114,1789,38,2096
4046,7,1,0,131,113,1795,38,2085
4047,7,0,0,128,114,1794,38,2081
4048,7,0,0,127,113,1793,38,2078
4049,7,1,0,126,113,1801,39,2087
4050,7,0,0,124,113,1802,38,2084
4051,7,0,0,124,113,1803,38,2085
4052,7,0,0,122,114,1801,38,2082
4053,7,0,0,122,114,1808,38,2089
4054,7,0,0,0,113,1793,38,1951
4055,7,0,0,0,115,1797,39,1958
4056,7,0,0,1,113,1802,38,1961
4057,6,0,0,0,107,1,38,152
4058,7,0,0,1,107,1,38,154
4059,6,1,0,1,107,1,39,155
4060,7,0,0,1,106,1,38,153
4061,7,0,0,0,107,1,38,153
4062,7,0,0,1,105,1,38,152
4063,7,0,0,0,106,0,39,152
4064,6,1,0,0,106,1,38,152
4065,6,0,0,0,105,1,39,151
4066,6,1,0,1,104,0,38,150
4067,7,0,0,0,106,1,39,153
4068,7,0,0,0,106,1,38,152
4069,7,0,0,0,104,1,38,150
4070,7,1,0,0,106,1,38,153
4071,7,1,0,0,104,1,38,151
4072,6,0,0,0,105,1,39,151
4073,6,0,0,1,104,1,39,151
4074,6,0,0,0,104,0,39,149
4075,6,1,0,1,104,37,39,188
4076,7,1,0,0,105,38,38,189
4077,6,0,0,0,103,37,39,185
4078,7,0,0,0,105,37,38,187
4079,6,0,0,0,105,37,38,186
4080,6,0,0,0,103,37,38,184
4081,7,1,0,0,104,35,39,186
4082,6,1,0,1,105,36,39,188
4083,7,0,0,0,105,37,38,187
4084,6,1,0,0,105,37,39,188
4085,6,0,0,0,104,36,39,185
4086,6,0,0,140,103,37,38,324
4087,7,1,0,140,104,36,38,326
4088,7,0,0,128,106,36,38,315
4089,7,1,0,127,106,36,38,315
4090,7,1,0,127,114,1536,38,1823
4091,7,0,0,124,114,1689,38,1972
4092,7,0,0,125,113,1713,39,1997
4093,7,0,0,126,114,1728,38,2013
4094,6,0,0,127,114,1742,38,2027
4095,6,1,0,0,113,1749,39,1908
4096,7,1,0,1,114,1758,38,1919
4097,7,0,0,0,113,1767,38,1925
4098,7,0,0,0,113,1771,39,1930
4099,7,0,0,0,114,1777,38,1936
4100,7,1,0,1,114,1785,38,1946
4101,6,0,0,0,114,1787,39,1946
4102,7,0,0,1,115,1790,38,1951
4103,7,1,0,1,114,1790,38,1951
4104,7,1,0,0,114,1793,38,1953
4105,7,2,0,0,114,1792,39,1954
4106,7,0,0,0,114,1791,39,1951
4107,7,0,0,0,113,1797,39,1956
4108,6,1,0,0,114,1807,39,1967
4109,7,0,0,0,114,1801,39,1961
4110,7,1,0,0,114,1808,39,1969
4111,7,0,0,0,114,1807,39,1967
4112,7,0,0,0,113,1809,39,1968
4113,6,0,0,0,113,1803,40,1962
4114,6,0,0,0,114,1802,38,1960
4115,7,0,0,0,107,1,38,153
4116,6,0,0,0,107,1,39,153
4117,7,0,0,0,107,1,38,153
4118,7,1,0,0,106,1,39,154
4119,7,1,0,0,106,1,38,153
4120,7,0,0,0,106,1,38,152
4121,7,0,0,0,106,1,38,152
4122,7,0,0,0,106,1,38,152
4123,7,0,0,0,106,1,38,152
4124,7,1,0,0,106,1,38,153
4125,7,1,0,0,106,1,38,153
4126,7,0,0,142,104,1,38,292
4127,7,0,0,139,105,1,38,290
4128,7,1,0,128,106,1,38,281
4129,7,0,0,127,103,1,39,277
4130,7,0,0,126,105,0,38,276
4131,7,0,0,125,104,1,39,276
4132,7,0,0,125,105,1,39,277
4133,7,1,0,123,106,39,38,314
4134,7,0,0,122,106,37,37,309
4135,6,0,0,0,105,38,39,188
4136,7,0,0,0,105,37,39,188
4137,7,0,0,1,104,38,38,188
4138,7,0,0,0,103,38,38,186
4139,7,0,0,1,105,36,38,187
4140,7,1,0,1,104,37,38,188
4141,7,0,0,0,104,36,39,186
4142,7,0,0,1,104,37,38,187
4143,7,0,0,1,104,37,38,187
4144,7,0,0,0,104,38,38,187
4145,7,0,0,0,104,36,39,186
4146,7,1,0,0,103,36,39,186
4147,7,0,0,0,104,36,39,186
4148,7,0,0,0,104,36,39,186
4149,7,0,0,0,106,36,38,187
4150,7,0,0,0,106,37,39,189
4151,7,0,0,1,104,36,39,187
4152,7,0,0,0,114,1529,38,1688
4153,7,0,0,0,114,1693,38,1852
4154,6,0,0,10,114,1755,38,1923
4155,6,1,0,7,114,1735,39,1902
4156,6,0,0,0,114,1759,39,1918
4157,7,0,0,0,114,1758,39,1918
4158,7,0,0,0,115,1779,39,1940
4159,7,0,0,0,114,1769,39,1929
4160,7,2,0,0,114,1786,38,1947
4161,7,0,0,1,114,1795,38,1955
4162,7,0,0,1,113,1795,38,1954
4163,7,1,0,1,116,1802,39,1966
4164,7,0,0,145,115,1798,38,2103
4165,7,0,0,132,114,1806,38,2097
4166,7,0,0,128,113,1809,38,2095
4167,7,1,0,127,114,1803,38,2090
4168,7,0,0,126,114,1813,38,2098
4169,7,0,0,125,113,1814,39,2098
4170,7,0,0,124,114,1815,38,2098
4171,7,1,0,124,113,1816,38,2099
4172,7,0,0,0,108,1,39,155
4173,7,0,0,0,106,1,39,153
4174,7,0,0,1,106,1,38,153
4175,7,2,0,0,106,0,39,154
4176,7,0,0,1,107,1,39,155
4177,7,0,0,1,106,0,39,153
4178,6,0,0,0,105,1,39,151
4179,7,0,0,10,106,1,39,163
4180,7,1,0,7,106,0,38,159
4181,7,0,0,7,106,1,39,160
4182,7,1,0,7,106,1,38,160
4183,6,0,0,7,106,1,39,159
4184,7,0,0,7,106,1,39,160
4185,7,0,0,7,105,1,39,159
4186,7,1,0,7,106,1,39,161
4187,7,0,0,7,104,1,38,157
4188,7,0,0,7,105,1,38,158
4189,7,0,0,150,104,38,38,337
4190,7,1,0,138,105,38,39,328
4191,7,0,0,136,104,36,38,321
4192,7,0,0,136,105,38,38,324
4193,7,0,0,135,105,37,39,323
4194,7,0,0,133,105,38,38,321
4195,7,0,0,132,104,36,38,317
4196,6,0,0,133,103,36,38,316
4197,7,1,0,132,103,37,39,319
4198,7,0,0,132,104,37,39,319
4199,7,0,0,132,104,37,38,318
4200,7,0,0,132,104,37,39,319
4201,7,1,0,130,104,38,38,318
4202,7,0,0,130,104,36,39,316
4203,7,0,0,129,104,36,38,314
4204,7,0,0,128,104,37,38,314
4205,6,1,0,7,104,38,38,194
4206,7,0,0,7,104,37,38,193
4207,7,0,0,7,105,36,39,194
4208,7,0,0,7,106,38,38,196
4209,7,0,0,10,106,37,39,199
4210,7,1,0,1,106,37,39,191
4211,7,0,0,0,104,38,39,188
4212,7,0,0,0,106,37,39,189
4213,7,0,0,0,114,1401,38,1560
4214,7,0,0,0,116,1640,39,1802
4215,6,0,0,506,113,1739,38,2402
4216,7,0,0,143,114,1718,39,2021
4217,7,0,0,131,115,1754,39,2046
4218,7,0,0,128,114,1759,39,2047
4219,7,0,0,127,114,1759,39,2046
4220,7,0,0,126,114,1770,38,2055
4221,6,0,0,125,113,1777,39,2060
4222,7,0,0,124,114,1792,38,2075
4223,7,0,0,123,113,1794,39,2076
4224,7,0,0,0,114,1795,39,1955
4225,7,0,0,0,114,1794,40,1955
4226,7,0,0,0,113,1797,38,1955
4227,7,0,0,0,115,1794,38,1954
4228,7,0,0,0,114,1810,39,1970
4229,7,0,0,0,114,1813,39,1973
4230,6,0,0,0,114,1809,39,1968
4231,7,0,0,0,114,1819,39,1979
4232,7,0,0,0,114,1815,39,1975
4233,7,0,0,0,114,1818,38,1977
4234,7,1,0,0,114,1817,38,1977
4235,7,0,0,0,114,1837,39,1997
4236,7,0,0,0,114,1816,39,1976
4237,7,0,0,0,107,1,38,153
4238,7,0,0,0,108,1,38,154
4239,7,0,0,81,108,1,39,236
4240,333,0,0,0,107,0,38,478
4241,331,1,0,0,106,0,207,645
4242,331,0,0,0,107,1,281,720
4243,332,0,0,0,106,1,283,722
4244,333,0,0,0,105,1,293,732
4245,334,0,0,0,105,1,340,780
4246,334,0,0,0,106,0,341,781
4247,333,0,0,0,104,1,265,703
4248,333,0,0,0,104,0,319,756
4249,333,0,0,0,103,1,227,664
4250,333,0,0,0,105,1,285,724
4251,333,1,0,0,104,1,245,684
4252,333,1,0,0,104,0,273,711
4253,333,0,0,0,106,1,290,730
4254,334,1,0,0,105,38,278,756
4255,332,0,0,0,104,37,278,751
4256,331,1,0,144,105,38,280,899
4257,331,1,0,131,104,36,260,863
4258,328,0,0,127,104,37,272,868
4259,330,1,0,127,104,36,270,868
4260,330,0,0,126,105,37,275,873
4261,329,0,0,126,104,37,289,885
4262,329,0,0,123,103,36,268,859
4263,327,0,0,201,103,36,283,950
4264,329,1,0,122,104,36,290,882
4265,329,0,0,79,104,35,290,837
4266,329,0,0,9,104,37,275,754
4267,329,0,0,7,104,36,276,752
4268,331,0,0,7,104,36,209,687
4269,331,0,0,86,104,36,238,795
4270,332,0,0,7,104,36,238,717
4271,330,0,0,7,103,36,225,701
4272,329,0,0,7,104,37,249,726
4273,329,1,0,7,104,38,318,797
4274,329,1,0,7,104,36,271,748
4275,328,0,0,6,103,36,286,759
4276,327,1,0,148,104,36,291,907
4277,327,0,0,139,104,36,293,899
4278,325,0,0,137,104,37,282,885
4279,324,1,0,136,103,35,265,864
4280,324,1,0,135,103,36,257,856
4281,325,1,0,135,103,36,263,863
4282,328,1,0,134,104,36,242,845
4283,325,1,0,134,104,36,248,848
4284,325,1,0,133,103,36,240,838
4285,325,1,0,132,103,34,249,844
4286,324,2,0,133,104,37,238,838
4287,325,1,0,131,102,35,257,851
4288,326,1,0,130,103,36,248,844
4289,327,0,0,130,104,37,248,846
4290,328,0,0,131,104,35,270,868
4291,329,0,0,209,105,35,289,967
4292,330,1,0,130,104,36,260,861
4293,329,1,0,131,104,35,276,876
4294,327,2,0,131,103,36,261,860
4295,327,1,0,130,102,36,131,727
4296,325,2,0,130,103,35,48,643
4297,324,1,0,7,103,35,48,518
4298,329,1,0,7,106,37,48,528
4299,331,1,0,7,104,36,49,528
4300,328,2,0,7,105,36,48,526
4301,333,0,0,7,105,35,49,529
4302,331,0,0,7,106,36,49,529
4303,361,0,0,7,106,36,49,559
4304,376,1,0,6,105,36,48,572
4305,376,0,0,156,106,35,48,721
4306,399,1,0,140,106,36,48,730
4307,403,0,0,135,106,35,48,727
4308,397,2,0,134,105,37,48,723
4309,401,0,0,138,106,36,49,730
4310,396,0,0,136,103,35,48,718
4311,396,1,0,135,104,36,49,721
4312,406,0,0,134,106,35,49,730
4313,397,1,0,136,104,35,48,721
4314,398,1,0,130,106,36,48,719
4315,399,0,0,127,103,35,48,712
4316,398,1,0,126,105,36,48,714
4317,401,1,0,124,106,35,49,716
4318,403,0,0,123,103,36,48,713
4319,391,1,0,123,103,36,48,702
4320,393,0,0,122,105,36,48,704
4321,397,0,0,0,104,37,49,587
4322,400,0,0,0,105,35,49,589
4323,396,0,0,0,107,35,49,587
4324,393,0,0,0,104,36,48,581
4325,395,0,0,0,105,35,50,585
4326,395,1,0,0,106,36,48,586
4327,396,0,0,0,104,35,48,583
4328,33,0,0,0,105,36,38,212
4329,37,0,0,0,105,36,38,216
4330,35,0,0,0,105,36,38,214
4331,37,1,0,0,105,36,39,218
4332,35,0,0,0,106,35,38,214
4333,35,0,0,1,103,35,38,212
4334,35,0,0,0,103,35,39,212
4335,39,0,0,0,105,36,38,218
4336,35,0,0,0,104,35,38,212
4337,35,0,0,0,105,36,38,214
4338,35,1,0,0,104,36,38,214
4339,35,0,0,0,104,35,38,212
4340,35,1,0,0,106,36,38,216
4341,35,1,0,0,105,36,38,215
4342,35,0,0,0,104,36,38,213
4343,35,0,0,0,105,35,38,213
4344,35,2,0,0,104,35,39,215
4345,35,0,0,0,104,35,38,212
4346,35,0,0,0,106,35,38,214
4347,35,1,0,0,103,35,38,212
4348,35,0,0,0,106,35,39,215
4349,35,0,0,141,106,37,38,357
4350,33,1,0,130,105,35,38,342
4351,33,0,0,127,104,35,38,337
4352,33,0,0,126,104,36,38,337
4353,33,1,0,125,104,36,39,338
4354,33,0,0,124,104,36,38,335
4355,23,0,0,124,104,35,38,324
4356,23,1,0,122,104,35,38,323
4357,23,1,0,122,104,35,39,324
4358,23,0,0,0,106,35,39,203
4359,23,0,0,0,103,35,38,199
4360,23,0,0,0,104,36,38,201
4361,22,0,0,0,103,35,39,199
4362,23,0,0,0,104,35,39,201
4363,377,1,0,0,105,35,38,556
4364,376,0,0,0,104,35,38,553
4365,377,0,0,0,105,35,39,556
4366,374,0,0,0,106,35,38,553
4367,381,0,0,0,105,36,38,560
4368,374,0,0,0,106,36,40,556
4369,377,1,0,0,103,34,39,554
4370,368,0,0,0,105,36,39,548
4371,374,1,0,0,104,34,39,552
4372,370,1,0,0,103,34,38,546
4373,374,2,0,9,103,35,39,562
4374,367,1,0,9,105,34,38,554
4375,366,0,0,0,103,35,38,542
4376,363,0,0,0,104,36,38,541
4377,362,1,0,0,105,34,38,540
4378,362,0,0,0,103,36,38,539
4379,369,0,0,0,103,35,38,545
4380,368,0,0,0,103,37,38,546
4381,367,1,0,0,105,36,39,548
4382,369,0,0,0,103,35,38,545
4383,370,0,0,144,104,35,38,691
4384,384,0,0,139,104,35,38,700
4385,369,1,0,128,104,36,38,676
4386,369,1,0,127,104,36,39,676
4387,365,0,0,125,103,36,38,667
4388,365,0,0,125,103,36,39,668
4389,361,1,0,123,105,35,38,663
4390,370,0,0,122,105,36,38,671
4391,364,0,0,121,104,36,38,663
4392,362,2,0,0,103,35,38,540
4393,367,0,0,0,103,34,38,542
4394,361,0,0,0,104,35,38,538
4395,366,0,0,0,103,36,38,543
4396,366,0,0,0,104,36,38,544
4397,365,0,0,78,104,35,38,620
4398,370,0,0,78,104,35,38,625
4399,374,0,0,0,103,35,38,550
4400,27,0,0,7,104,35,38,211
4401,29,0,0,6,103,34,39,211
4402,26,1,0,7,105,34,38,211
4403,26,0,0,7,104,34,38,209
4404,26,0,0,7,103,35,38,209
4405,33,0,0,7,103,35,38,216
4406,33,0,0,6,103,36,39,217
4407,33,0,0,156,103,34,38,364
4408,35,1,0,141,104,35,38,354
4409,33,1,0,136,103,35,38,346
4410,32,0,0,135,104,34,38,343
4411,32,0,0,134,104,35,38,343
4412,32,1,0,133,104,34,38,342
4413,32,0,0,132,102,35,38,339
4414,41,0,0,132,103,35,39,350
4415,43,0,0,131,103,34,38,349
4416,371,0,0,130,103,34,38,676
4417,365,1,0,130,104,36,39,675
4418,364,0,0,129,104,34,38,669
4419,365,0,0,129,103,34,39,670
4420,364,0,0,128,104,36,38,670
4421,364,0,0,128,104,34,38,668
4422,364,0,0,129,104,36,38,671
4423,363,0,0,127,105,35,38,668
4424,366,0,0,127,103,35,38,669
4425,363,0,0,127,104,35,38,667
4426,364,1,0,127,103,36,39,670
4427,362,0,0,6,103,35,38,544
4428,362,0,0,7,103,36,38,546
4429,366,0,0,6,103,34,38,547
4430,365,0,0,6,103,35,38,547
4431,366,0,0,6,103,35,38,548
4432,367,0,0,7,103,35,38,550
4433,366,0,0,7,104,35,39,551
4434,367,0,0,0,104,35,38,544
4435,368,0,0,0,104,35,38,545
4436,370,1,0,0,105,35,39,550
4437,367,0,0,146,104,36,38,691
4438,368,0,0,131,103,35,38,675
4439,367,0,0,129,103,35,38,672
4440,376,0,0,127,103,35,38,679
4441,368,0,0,126,105,35,38,672
4442,370,1,0,127,104,36,38,676
4443,370,0,0,124,104,35,38,671
4444,369,0,0,123,104,36,38,670
4445,364,0,0,121,104,34,38,661
4446,366,0,0,120,103,34,38,661
4447,366,1,0,0,103,36,38,544
4448,368,0,0,0,104,36,38,546
4449,368,0,0,0,103,34,39,544
4450,368,0,0,0,104,36,38,546
4451,370,1,0,0,104,36,38,549
4452,370,0,0,0,104,36,38,548
4453,370,0,0,0,103,35,38,546
4454,368,0,0,0,104,36,37,545
4455,368,0,0,0,103,36,39,546
4456,369,0,0,0,104,35,39,547
4457,371,0,0,0,103,35,38,547
4458,369,1,0,0,104,36,38,548
4459,369,0,0,0,104,36,38,547
4460,58,1,0,1,103,36,38,237
4461,57,1,0,1,103,36,38,236
4462,57,1,0,1,104,36,38,237
4463,10,0,0,0,104,36,38,188
4464,7,0,0,0,104,34,38,183
4465,7,0,0,0,103,36,39,185
4466,7,0,0,0,103,37,39,186
4467,7,1,0,0,103,35,38,184
4468,7,0,0,0,103,36,38,184
4469,324,1,0,0,103,35,38,501
4470,324,0,0,0,103,35,38,500
4471,325,0,0,0,105,35,38,503
4472,327,0,0,0,104,36,38,505
4473,327,0,0,0,103,35,38,503
4474,327,0,0,0,103,35,38,503
4475,326,0,0,0,103,36,38,503
4476,326,0,0,0,103,35,38,502
4477,324,1,0,0,103,36,39,503
4478,325,0,0,144,103,36,39,647
4479,383,1,0,132,103,35,38,692
4480,367,0,0,126,103,36,38,670
4481,363,1,0,126,103,36,38,667
4482,369,1,0,124,102,36,38,670
4483,363,0,0,124,103,36,38,664
4484,364,1,0,124,104,36,38,667
4485,365,0,0,122,103,35,38,663
4486,366,1,0,122,103,36,38,666
4487,372,0,0,121,103,36,37,669
4488,37,1,0,0,104,35,38,215
4489,26,1,0,0,104,35,38,204
4490,26,0,0,0,104,35,38,203
4491,26,1,0,0,104,36,39,206
4492,26,0,0,0,104,36,38,204
4493,26,1,0,0,104,35,39,205
4494,34,0,0,10,103,35,38,220
4495,154,0,0,0,111,929,38,1232
4496,371,0,0,0,115,1552,38,2076
4497,361,1,0,0,112,1674,38,2186
4498,28,0,0,0,114,1681,38,1861
4499,28,0,0,0,112,1721,38,1899
4500,26,1,0,0,112,1730,38,1907
4501,26,2,0,0,113,1747,38,1926
4502,26,1,0,0,113,1759,38,1937
4503,26,0,0,0,114,1770,38,1948
4504,33,0,0,0,114,1776,38,1961
4505,33,0,0,0,114,1776,38,1961
4506,33,0,0,0,114,1787,38,1972
4507,33,0,0,0,113,1785,38,1969
4508,33,0,0,0,114,1792,39,1978
4509,33,2,0,0,114,1793,38,1980
4510,34,0,0,0,113,1795,38,1980
4511,33,0,0,0,114,1797,38,1982
4512,33,1,0,0,114,1798,39,1985
4513,36,0,0,10,113,1799,38,1996
4514,32,0,0,142,113,1800,39,2126
4515,32,0,0,144,112,1798,39,2125
4516,33,0,0,134,107,1,39,314
4517,33,0,0,134,107,1,39,314
4518,34,0,0,133,106,0,38,311
4519,33,0,0,132,105,1,39,310
4520,33,0,0,132,106,0,38,309
4521,33,1,0,131,104,1,38,308
4522,29,0,0,131,105,1,39,305
4523,25,0,0,130,104,0,38,297
4524,29,0,0,130,106,1,39,305
4525,28,1,0,130,106,1,38,304
4526,22,0,0,129,104,1,38,294
4527,22,0,0,130,105,1,39,297
4528,32,0,0,129,104,1,38,304
4529,27,1,0,129,103,1,39,300
4530,26,0,0,127,104,1,39,297
4531,25,1,0,127,104,39,38,334
4532,25,0,0,7,103,36,38,209
4533,25,0,0,7,104,37,38,211
4534,25,0,0,7,103,36,38,209
4535,26,1,0,7,103,36,38,211
4536,25,0,0,7,103,37,38,210
4537,25,0,0,7,103,36,38,209
4538,25,0,0,7,104,36,38,210
4539,26,0,0,7,105,35,38,211
4540,26,0,0,7,104,37,38,212
4541,380,0,0,143,104,36,39,702
4542,373,1,0,143,104,36,38,695
4543,373,1,0,132,104,36,38,684
4544,373,0,0,129,105,36,38,681
4545,373,0,0,128,105,36,38,680
4546,373,1,0,127,103,35,38,677
4547,375,0,0,125,105,36,38,679
4548,374,1,0,124,105,36,39,679
4549,375,0,0,123,106,36,38,678
4550,374,0,0,122,106,36,38,676
4551,373,0,0,122,106,35,39,675
4552,374,0,0,0,105,37,38,554
4553,371,0,0,0,104,36,38,549
4554,372,0,0,0,105,37,38,552
4555,371,1,0,0,106,35,38,551
4556,369,0,0,0,103,37,38,547
4557,367,1,0,0,105,36,39,548
4558,372,0,0,0,104,35,39,550
4559,372,0,0,0,103,36,39,550
4560,372,0,0,0,104,35,39,550
4561,371,0,0,0,105,36,38,550
4562,380,0,0,0,106,36,38,560
4563,371,0,0,0,105,35,219,730
4564,370,1,0,0,106,36,212,725
4565,370,0,0,0,105,35,215,725
4566,371,0,0,0,104,36,242,753
4567,373,0,0,0,103,36,237,749
4568,372,1,0,0,111,1025,289,1798
4569,371,0,0,0,114,1549,244,2278
4570,371,0,0,0,114,1686,239,2410
4571,367,0,0,0,114,1697,226,2404
4572,368,0,0,0,113,1720,245,2446
4573,367,0,0,0,113,1744,384,2608
4574,371,0,0,0,113,1752,194,2430
4575,371,0,0,0,113,1768,246,2498
4576,370,0,0,0,114,1771,38,2293
4577,375,0,0,0,113,1778,37,2303
4578,377,0,0,0,114,1778,37,2306
4579,375,0,0,0,114,1785,38,2312
4580,382,1,0,0,114,1792,38,2327
4581,381,1,0,0,114,1793,37,2326
4582,373,0,0,0,114,1795,37,2319
4583,374,0,0,145,113,1798,37,2467
4584,374,0,0,132,114,1798,37,2455
4585,377,0,0,128,113,1806,37,2461
4586,383,1,0,127,114,1808,38,2471
4587,377,1,0,125,108,1,38,650
4588,375,0,0,124,108,1,39,647
4589,373,1,0,123,105,0,39,641
4590,373,1,0,123,106,1,39,643
4591,372,0,0,123,105,1,38,639
4592,374,0,0,122,105,1,38,640
4593,373,0,0,0,104,1,38,516
4594,373,0,0,0,104,1,39,517
4595,376,0,0,0,105,1,38,520
4596,373,1,0,0,104,1,39,518
4597,373,0,0,0,106,1,38,518
4598,375,0,0,0,103,0,38,516
4599,374,0,0,0,105,0,38,517
4600,377,0,0,6,104,1,39,527
4601,380,0,0,0,105,1,38,524
4602,376,0,0,0,105,1,38,520
4603,377,0,0,0,104,1,38,520
4604,377,0,0,0,103,38,38,556
4605,377,1,0,0,105,37,39,559
4606,377,0,0,0,103,36,38,554
4607,377,0,0,0,104,37,38,556
4608,371,0,0,0,103,36,38,548
4609,373,0,0,0,104,36,38,551
4610,372,1,0,0,104,36,38,551
4611,379,1,0,0,102,36,39,557
4612,374,1,0,0,104,36,38,553
4613,369,0,0,0,103,36,38,546
4614,333,1,0,0,104,36,38,512
4615,329,1,0,0,103,37,197,667
4616,330,1,0,0,103,35,286,755
4617,330,0,0,0,104,36,251,721
4618,330,1,0,0,104,36,227,698
4619,329,0,0,149,105,37,220,840
4620,330,0,0,137,103,36,221,827
4621,331,0,0,128,104,36,262,861
4622,334,0,0,126,104,36,244,844
4623,332,0,0,127,104,36,237,836
4624,333,0,0,124,106,36,328,927
4625,333,0,0,124,106,36,260,859
4626,331,1,0,122,104,37,231,826
4627,332,0,0,122,104,38,244,840
4628,332,1,0,122,104,36,227,822
4629,331,0,0,0,105,38,222,696
4630,333,1,0,0,104,37,228,703
4631,333,0,0,0,104,37,234,708
4632,331,1,0,0,106,37,286,761
4633,331,0,0,0,104,36,221,692
4634,332,0,0,0,104,35,226,697
4635,333,1,0,0,104,36,247,721
4636,333,0,0,0,104,37,252,726
4637,334,1,0,0,104,36,276,751
4638,332,0,0,0,114,1330,234,2010
4639,333,1,0,0,114,1600,250,2298
4640,334,0,0,0,115,1712,225,2386
4641,332,0,0,0,115,1707,232,2386
4642,334,1,0,0,115,1725,299,2474
4643,332,0,0,0,114,1741,385,2572
4644,334,0,0,0,114,1745,218,2411
4645,329,0,0,0,113,1761,284,2487
4646,332,0,0,0,115,1762,223,2432
4647,328,0,0,0,113,1773,218,2432
4648,328,1,0,0,114,1776,278,2497
4649,330,0,0,0,114,1777,259,2480
4650,331,0,0,0,114,1783,338,2566
4651,334,1,0,0,115,1789,308,2547
4652,336,0,0,0,114,1790,266,2506
4653,336,0,0,0,115,1794,240,2485
4654,334,0,0,0,113,1795,250,2492
4655,331,1,0,0,115,1793,224,2464
4656,331,0,0,0,113,1795,221,2460
4657,331,0,0,0,114,1798,222,2465
4658,331,0,0,0,114,1798,332,2575
4659,330,0,0,0,113,1800,229,2472
4660,332,0,0,0,106,1,218,657
4661,333,0,0,7,106,0,218,664
4662,333,0,0,153,106,1,215,808
4663,332,0,0,137,106,1,385,961
4664,330,1,0,136,105,1,233,806
4665,332,0,0,134,105,1,308,880
4666,332,0,0,132,104,0,270,838
4667,332,0,0,132,105,0,223,792
4668,331,1,0,131,104,0,286,853
4669,331,0,0,131,104,0,317,883
4670,334,0,0,131,106,1,392,964
4671,334,0,0,131,106,1,242,814
4672,334,1,0,131,105,0,301,872
4673,334,0,0,129,106,0,239,808
4674,334,0,0,129,105,1,236,805
4675,333,0,0,130,104,0,384,951
4676,334,0,0,129,105,1,231,800
4677,334,1,0,128,104,39,261,867
4678,334,1,0,129,104,37,395,1000
4679,336,1,0,128,105,37,214,821
4680,334,0,0,7,104,36,255,736
4681,335,0,0,7,104,37,218,701
4682,334,0,0,7,103,37,252,733
4683,334,1,0,7,104,36,255,737
4684,334,0,0,7,105,36,301,783
4685,335,1,0,7,104,37,244,728
4686,336,0,0,6,104,37,249,732
4687,335,0,0,0,104,36,241,716
4688,334,0,0,0,103,36,270,743
4689,334,1,0,155,103,36,244,873
4690,334,0,0,139,104,37,234,848
4691,333,1,0,130,104,37,245,850
4692,333,0,0,128,104,37,294,896
4693,334,0,0,127,104,36,239,840
4694,335,0,0,126,105,37,247,850
4695,336,0,0,125,107,36,238,842
4696,334,0,0,125,114,1389,249,2211
4697,331,0,0,122,114,1614,261,2442
4698,331,0,0,121,113,1713,267,2545
4699,330,0,0,122,113,1709,267,2541
4700,331,0,0,0,114,1727,318,2490
4701,334,0,0,0,115,1749,264,2462
4702,335,0,0,0,115,1752,226,2428
4703,334,0,0,0,114,1763,242,2453
4704,334,0,0,0,115,1762,303,2514
4705,334,0,0,0,113,1773,236,2456
4706,334,0,0,0,115,1782,222,2453
4707,335,0,0,0,114,1781,234,2464
4708,333,0,0,0,113,1789,231,2466
4709,334,0,0,0,114,1792,215,2455
4710,334,0,0,0,114,1795,220,2463
4711,332,0,0,0,113,1794,223,2462
4712,217,0,0,0,113,1797,37,2164
4713,7,0,0,0,114,1799,37,1957
4714,7,0,0,0,114,1801,38,1960
4715,7,0,0,0,115,1806,38,1966
4716,7,0,0,0,114,1803,37,1961
4717,7,0,0,0,113,1801,37,1958
4718,7,0,0,0,107,1,37,152
4719,7,0,0,1,106,1,38,153
4720,7,0,0,0,106,1,37,151
4721,7,1,0,0,106,1,38,153
4722,7,0,0,0,106,1,38,152
4723,7,1,0,0,106,1,38,153
4724,7,0,0,0,105,1,38,151
4725,7,0,0,0,106,1,38,152
4726,7,0,0,0,106,1,39,153
4727,7,0,0,0,106,1,39,153
4728,7,0,0,0,106,0,39,152
4729,7,0,0,0,107,1,38,153
4730,7,0,0,0,105,1,39,152
4731,7,0,0,0,106,1,38,152
4732,7,0,0,148,104,39,39,337
4733,7,0,0,138,105,38,38,326
4734,7,1,0,128,105,38,39,318
4735,7,0,0,128,106,38,38,317
4736,7,0,0,126,105,36,38,312
4737,7,0,0,125,106,36,38,312
4738,7,0,0,124,105,36,38,310
4739,7,0,0,123,105,37,39,311
4740,7,0,0,122,103,37,39,308
4741,7,0,0,121,103,37,38,306
4742,7,0,0,1,104,36,39,187
4743,7,0,0,0,103,37,38,185
4744,7,0,0,0,104,37,38,186
4745,7,0,0,0,105,37,38,187
4746,7,0,0,0,103,36,39,185
4747,7,0,0,10,105,37,38,197
4748,7,0,0,1,104,36,38,186
4749,7,0,0,0,104,37,39,187
4750,7,0,0,0,104,36,39,186
4751,7,0,0,0,103,37,38,185
4752,7,0,0,0,104,36,38,185
4753,7,1,0,1,105,36,38,188
4754,7,0,0,0,114,1092,39,1252
4755,7,1,0,0,114,1553,38,1713
4756,7,0,0,0,115,1688,39,1849
4757,7,1,0,0,115,1699,38,1860
4758,7,2,0,0,115,1733,38,1895
4759,7,0,0,0,115,1744,38,1904
4760,7,1,0,1,115,1751,39,1914
4761,7,1,0,0,114,1766,39,1927
4762,7,0,0,0,115,1770,38,1930
4763,7,1,0,1,114,1776,38,1937
4764,7,0,0,0,114,1782,38,1941
4765,7,0,0,0,113,1787,38,1945
4766,7,0,0,0,114,1787,39,1947
4767,7,0,0,0,115,1795,39,1956
4768,7,0,0,0,114,1798,38,1957
4769,7,0,0,0,115,1798,38,1958
4770,7,0,0,146,114,1801,38,2106
4771,7,1,0,134,115,1801,38,2096
4772,7,0,0,128,114,1802,38,2089
4773,7,0,0,127,115,1805,38,2092
4774,7,0,0,126,114,1810,39,2096
4775,7,0,0,126,114,1805,38,2090
4776,7,1,0,124,115,1809,39,2095
4777,7,0,0,124,115,1810,39,2095
4778,7,0,0,122,114,1810,39,2092
4779,7,1,0,0,107,1,39,155
4780,7,0,0,0,107,1,39,154
4781,7,0,0,0,106,1,38,152
4782,7,0,0,1,106,1,38,153
4783,7,1,0,0,106,1,38,153
4784,7,0,0,0,106,1,39,153
4785,7,0,0,0,106,0,39,152
4786,7,0,0,0,106,1,39,153
4787,7,1,0,0,106,1,39,154
4788,7,1,0,0,104,1,39,152
4789,7,0,0,1,105,0,38,151
4790,7,1,0,0,105,1,39,153
4791,7,0,0,0,106,1,39,153
4792,7,1,0,0,104,1,38,151
4793,7,0,0,0,106,1,38,152
4794,7,1,0,0,104,1,38,151
4795,7,1,0,0,104,0,39,151
4796,7,0,0,0,104,42,38,191
4797,7,0,0,0,105,38,37,187
4798,7,1,0,0,105,38,38,189
4799,7,0,0,0,104,38,39,188
4800,7,0,0,0,104,37,38,186
4801,7,0,0,0,104,38,38,187
4802,7,1,0,0,104,38,39,189
4803,7,0,0,0,103,37,38,185
4804,7,0,0,0,105,38,39,189
4805,7,0,0,1,105,38,39,190
4806,7,1,0,0,104,37,38,187
4807,7,0,0,10,104,36,38,195
4808,7,1,0,10,104,36,38,196
4809,7,1,0,0,103,37,38,186
4810,7,0,0,0,103,36,39,185
4811,7,0,0,0,103,37,39,186
4812,7,2,0,146,113,1366,39,1673
4813,7,0,0,132,114,1617,38,1908
4814,7,1,0,129,115,1706,38,1996
4815,7,0,0,126,114,1738,38,2023
4816,7,0,0,127,114,1721,39,2008
4817,7,0,0,125,114,1741,38,2025
4818,7,0,0,124,115,1753,38,2037
4819,7,0,0,126,114,1758,38,2043
4820,7,1,0,125,113,1766,38,2050
4821,7,1,0,7,114,1771,39,1939
4822,7,0,0,7,114,1768,38,1934
4823,7,0,0,7,115,1785,38,1952
4824,7,1,0,7,113,1787,38,1953
4825,7,1,0,7,114,1785,38,1952
4826,7,0,0,7,114,1779,38,1945
4827,7,1,0,7,114,1782,38,1949
4828,7,1,0,7,114,1794,38,1961
4829,7,0,0,7,114,1799,38,1965
4830,7,1,0,7,114,1786,38,1953
4831,7,0,0,7,114,1797,38,1963
4832,7,0,0,151,114,1799,38,2109
4833,7,0,0,138,114,1803,38,2100
4834,7,0,0,137,113,1797,38,2092
4835,7,0,0,136,113,1792,38,2086
4836,7,1,0,134,113,1795,38,2088
4837,7,0,0,132,113,1801,38,2091
4838,7,0,0,133,113,1802,39,2094
4839,7,0,0,131,113,1807,38,2096
4840,7,0,0,131,113,1805,39,2095
4841,7,0,0,130,107,1,38,283
4842,7,1,0,130,105,1,38,282
4843,7,1,0,129,106,1,39,283
4844,7,0,0,131,106,1,38,283
4845,7,0,0,129,106,1,38,281
4846,7,1,0,133,104,1,39,285
4847,7,0,0,127,105,1,39,279
4848,7,1,0,125,106,1,38,278
4849,7,0,0,0,105,1,39,152
4850,7,0,0,0,105,1,39,152
4851,7,0,0,0,106,1,38,152
4852,7,0,0,0,106,1,38,152
4853,7,0,0,0,104,1,39,151
4854,7,1,0,0,106,1,39,154
4855,7,0,0,1,103,0,38,149
4856,7,0,0,0,105,1,38,151
4857,7,1,0,0,105,38,38,189
4858,7,0,0,0,104,37,38,186
4859,7,0,0,0,105,37,38,187
4860,7,0,0,0,104,37,38,186
4861,7,0,0,0,105,37,38,187
4862,7,0,0,0,105,36,38,186
4863,7,0,0,1,105,37,38,188
4864,7,0,0,0,104,37,38,186
4865,7,0,0,0,104,36,38,185
4866,7,0,0,1,104,37,38,187
4867,7,0,0,0,105,37,38,187
4868,7,0,0,0,104,37,39,187
4869,7,0,0,0,104,37,39,187
4870,7,0,0,0,104,36,38,185
4871,7,0,0,1,104,37,38,187
4872,7,0,0,0,113,1521,39,1680
4873,7,0,0,0,114,1681,39,1841
4874,7,0,0,0,114,1746,38,1905
4875,7,1,0,0,115,1728,38,1889
4876,7,0,0,0,115,1734,39,1895
4877,7,1,0,138,113,1751,39,2049
4878,7,0,0,139,113,1763,38,2060
4879,7,0,0,129,115,1774,39,2064
4880,7,1,0,127,114,1773,38,2060
4881,7,1,0,126,114,1769,39,2056
4882,7,1,0,125,113,1781,38,2065
4883,7,0,0,125,114,1782,39,2067
4884,7,0,0,124,113,1792,38,2074
4885,7,0,0,123,114,1792,39,2075
4886,7,0,0,122,113,1795,39,2076
4887,7,1,0,0,114,1791,39,1952
4888,7,1,0,0,114,1798,38,1958
4889,7,0,0,0,114,1801,38,1960
4890,7,0,0,1,113,1800,39,1960
4891,7,0,0,0,113,1805,38,1963
4892,7,1,0,0,115,1801,38,1962
4893,7,0,0,0,114,1803,39,1963
4894,7,0,0,0,114,1801,37,1959
4895,7,0,0,0,114,1808,38,1967
4896,7,1,0,1,115,1805,38,1967
4897,7,0,0,0,115,1807,39,1968
4898,7,0,0,1,115,1811,38,1972
4899,7,1,0,0,114,1813,38,1973
4900,7,0,0,0,114,1814,37,1972
4901,7,0,0,0,114,1809,38,1968
4902,7,0,0,0,114,1809,38,1968
4903,7,0,0,0,114,1810,38,1969
4904,8,0,0,0,114,1810,38,1970
4905,7,0,0,0,107,1,38,153
4906,7,0,0,10,106,0,38,161
4907,7,0,0,10,106,1,38,162
4908,7,2,0,0,106,1,37,153
4909,7,2,0,0,106,0,38,153
4910,7,0,0,0,106,1,38,152
4911,7,0,0,0,106,1,38,152
4912,7,0,0,0,105,1,37,150
4913,7,0,0,0,106,1,38,152
4914,7,0,0,0,106,1,38,152
4915,7,0,0,1,106,1,38,153
4916,7,0,0,148,105,1,38,299
4917,7,0,0,135,104,1,38,285
4918,7,1,0,127,106,1,38,280
4919,7,0,0,127,104,1,38,277
4920,7,0,0,125,106,1,38,277
4921,7,0,0,125,105,41,38,316
4922,7,1,0,124,105,38,38,313
4923,7,0,0,123,105,37,38,310
4924,7,0,0,124,103,38,38,310
4925,7,1,0,123,104,37,37,309
4926,7,0,0,0,106,36,38,187
4927,7,0,0,0,106,38,38,189
4928,7,0,0,0,105,38,39,189
4929,7,0,0,0,105,36,39,187
4930,7,1,0,0,104,37,38,187
4931,7,0,0,0,105,36,38,186
4932,7,0,0,0,103,36,39,185
4933,7,1,0,0,104,37,38,187
4934,7,1,0,1,103,37,38,187
4935,7,0,0,1,104,38,38,188
4936,7,0,0,0,115,1420,38,1580
4937,7,0,0,0,114,1604,39,1764
4938,7,0,0,0,114,1666,39,1826
4939,7,0,0,0,115,1714,38,1874
4940,7,0,0,1,114,1737,39,1898
4941,7,0,0,0,114,1755,38,1914
4942,7,0,0,0,114,1766,38,1925
4943,7,1,0,0,115,1775,38,1936
4944,7,0,0,0,114,1781,38,1940
4945,7,1,0,0,114,1784,38,1944
4946,7,1,0,0,114,1787,39,1948
4947,7,0,0,0,114,1795,38,1954
4948,7,0,0,0,113,1791,38,1949
4949,7,1,0,0,113,1795,38,1954
4950,7,1,0,0,115,1795,38,1956
4951,7,0,0,0,114,1798,39,1958
4952,7,1,0,0,114,1801,38,1961
4953,7,0,0,0,113,1800,38,1958
4954,7,1,0,0,114,1803,38,1963
4955,7,0,0,1,115,1802,39,1964
4956,7,0,0,0,115,1803,39,1964
4957,7,1,0,0,114,1806,38,1966
4958,7,1,0,0,114,1807,38,1967
4959,7,1,0,0,115,1808,38,1969
4960,7,0,0,143,114,1810,38,2112
4961,7,0,0,130,114,1811,38,2100
4962,7,0,0,128,114,1808,38,2095
4963,7,0,0,127,114,1809,38,2095
4964,7,0,0,126,114,1807,38,2092
4965,7,0,0,124,114,1811,39,2095
4966,7,0,0,124,114,1808,39,2092
4967,7,0,0,127,106,1,38,279
4968,7,0,0,125,107,1,39,279
4969,7,0,0,0,106,1,38,152
4970,7,1,0,0,106,1,38,153
4971,7,1,0,0,106,1,38,153
4972,7,0,0,0,106,1,38,152
4973,7,1,0,0,106,1,38,153
4974,7,1,0,0,104,1,38,151
4975,7,0,0,0,105,1,38,151
4976,7,1,0,0,105,1,38,152
4977,7,0,0,0,106,1,39,153
4978,7,0,0,0,104,1,38,150
4979,7,0,0,0,105,0,38,150
4980,7,0,0,0,106,1,38,152
4981,7,1,0,0,105,0,39,152
4982,7,0,0,0,105,1,39,152
4983,7,0,0,1,104,39,38,189
4984,7,0,0,0,104,38,39,188
4985,7,0,0,0,107,38,38,190
4986,7,1,0,1,105,37,38,189
4987,7,0,0,10,105,37,38,197
4988,7,0,0,7,104,37,38,193
4989,7,0,0,7,104,38,38,194
4990,7,0,0,7,105,36,38,193
4991,7,1,0,7,104,38,38,195
4992,7,0,0,7,105,37,38,194
4993,7,0,0,7,114,1358,38,1524
4994,7,0,0,147,114,1610,39,1917
4995,7,0,0,137,114,1714,38,2010
4996,7,0,0,135,115,1721,39,2017
4997,7,0,0,136,114,1742,38,2037
4998,7,0,0,135,115,1754,39,2050
4999,7,0,0,133,114,1759,38,2051
5000,7,0,0,132,115,1774,38,2066
5001,7,0,0,132,114,1775,39,2067
5002,7,0,0,132,115,1785,39,2078
5003,7,0,0,131,114,1785,38,2075
5004,7,0,0,131,114,1791,39,2082
5005,7,1,0,132,114,1795,38,2087
5006,7,0,0,130,113,1799,38,2087
5007,7,0,0,130,114,1799,38,2088
5008,7,0,0,129,115,1805,39,2095
5009,7,0,0,128,114,1803,38,2090
5010,7,0,0,128,115,1806,38,2094
5011,7,0,0,128,115,1809,39,2098
5012,7,0,0,7,114,1810,38,1976
5013,7,0,0,7,114,1807,39,1974
5014,7,0,0,10,114,1808,39,1978
5015,7,0,0,0,114,1809,38,1968
5016,7,1,0,0,114,1813,38,1973
5017,7,0,0,0,114,1814,39,1974
5018,7,1,0,0,114,1813,38,1973
5019,7,0,0,0,114,1814,38,1973
5020,7,0,0,0,115,1816,39,1977
5021,7,0,0,0,109,1,39,156
5022,7,0,0,0,106,1,39,153
5023,7,0,0,1,107,1,38,154
5024,7,0,0,0,107,1,38,153
5025,7,0,0,151,107,1,38,304
5026,7,0,0,135,106,1,39,288
5027,7,0,0,128,106,1,38,280
5028,7,0,0,127,106,1,39,280
5029,7,0,0,126,106,1,39,279
5030,7,0,0,126,104,1,39,277
5031,7,0,0,125,106,0,38,276
5032,7,1,0,123,106,1,38,276
5033,7,0,0,122,107,1,38,275
5034,7,0,0,122,106,1,38,274
5035,7,0,0,0,104,1,39,151
5036,7,1,0,0,105,1,39,153
5037,7,0,0,0,105,1,39,152
5038,7,1,0,0,105,43,39,195
5039,7,0,0,0,106,39,38,190
5040,7,1,0,0,106,38,38,190
5041,7,1,0,0,106,37,38,189
5042,7,0,0,0,106,37,38,188
5043,7,0,0,1,104,36,38,186
5044,7,1,0,0,104,37,38,187
5045,7,0,0,0,104,37,39,187
5046,7,0,0,0,104,36,39,186
5047,7,1,0,1,105,37,39,190
5048,7,1,0,0,104,38,38,188
5049,7,0,0,1,114,1431,38,1591
5050,7,0,0,0,115,1616,39,1777
5051,7,1,0,0,115,1670,38,1831
5052,7,1,0,0,113,1726,38,1885
5053,7,0,0,0,114,1747,38,1906
5054,7,0,0,0,115,1755,38,1915
5055,7,0,0,0,113,1768,39,1927
5056,7,0,0,0,115,1777,39,1938
5057,7,0,0,0,113,1776,39,1935
5058,7,0,0,0,113,1784,38,1942
5059,7,0,0,0,113,1787,38,1945
5060,7,0,0,0,114,1791,38,1950
5061,7,0,0,0,114,1792,37,1950
5062,7,0,0,0,114,1794,38,1953
5063,7,0,0,0,114,1798,38,1957
5064,7,0,0,0,114,1799,37,1957
5065,7,1,0,1,114,1800,40,1963
5066,7,0,0,1,113,1798,39,1958
5067,7,1,0,0,114,1800,39,1961
5068,7,0,0,0,113,1803,38,1961
5069,7,1,0,142,115,1803,38,2106
5070,7,0,0,129,114,1807,38,2095
5071,7,0,0,127,113,1806,39,2092
5072,7,0,0,127,114,1808,38,2094
5073,7,0,0,125,114,1805,38,2089
5074,7,1,0,127,113,1805,39,2092
5075,7,0,0,126,113,1811,38,2095
5076,7,0,0,123,114,1809,39,2092
5077,7,1,0,122,113,1811,38,2092
5078,7,0,0,0,107,1,38,153
5079,7,0,0,0,106,1,38,152
5080,7,0,0,0,107,1,39,154
5081,7,0,0,0,106,1,39,153
5082,7,0,0,0,106,0,39,152
5083,7,0,0,0,106,1,38,152
5084,7,1,0,1,106,1,38,154
5085,7,0,0,0,106,1,39,153
5086,7,0,0,0,105,1,38,151
5087,7,0,0,0,105,1,38,151
5088,7,0,0,0,106,1,38,152
5089,7,1,0,0,104,1,38,151
5090,7,0,0,1,103,1,39,151
5091,7,0,0,0,106,1,39,153
5092,7,0,0,1,105,1,39,153
5093,7,0,0,0,104,1,38,150
5094,7,0,0,0,105,43,39,194
5095,7,1,0,0,105,38,39,190
5096,7,1,0,0,104,38,38,188
5097,7,1,0,0,106,36,39,189
5098,7,1,0,0,104,36,38,186
5099,7,0,0,0,104,37,38,186
5100,7,0,0,0,104,38,38,187
5101,7,1,0,0,105,37,38,188
5102,7,0,0,0,104,36,38,185
5103,7,0,0,0,104,36,38,185
5104,7,0,0,0,104,36,39,186
5105,7,0,0,0,104,36,39,186
5106,7,0,0,0,104,36,38,185
5107,7,0,0,0,104,36,38,185
5108,7,0,0,0,104,37,39,187
5109,7,0,0,0,104,37,38,186
5110,7,1,0,0,104,37,38,187
5111,7,0,0,144,103,36,39,329
5112,7,0,0,138,104,37,38,324
5113,7,0,0,128,104,37,38,314
5114,7,0,0,127,103,37,38,312
5115,7,0,0,125,103,37,38,310
5116,7,0,0,125,104,36,39,311
5117,7,0,0,124,105,36,38,310
5118,7,0,0,122,104,36,38,307
5119,7,0,0,122,113,1437,38,1717
5120,7,0,0,122,113,1626,39,1907
5121,7,0,0,0,113,1714,39,1873
5122,7,0,0,0,114,1720,38,1879
5123,7,0,0,0,113,1733,38,1891
5124,7,1,0,0,114,1751,37,1910
5125,7,0,0,0,114,1757,38,1916
5126,7,0,0,0,115,1767,39,1928
5127,7,0,0,0,115,1770,38,1930
5128,7,0,0,0,113,1774,39,1933
5129,7,0,0,0,113,1778,39,1937
5130,7,1,0,0,115,1782,38,1943
5131,7,0,0,0,114,1781,38,1940
5132,7,0,0,0,114,1789,38,1948
5133,7,0,0,0,114,1787,39,1947
5134,7,1,0,0,113,1793,38,1952
5135,7,1,0,7,114,1789,38,1956
5136,7,0,0,0,113,1794,38,1952
5137,7,0,0,0,114,1791,38,1950
5138,7,0,0,0,113,1797,39,1956
5139,7,0,0,0,113,1793,38,1951
5140,7,1,0,1,114,1794,39,1956
5141,7,0,0,0,114,1797,38,1956
5142,7,0,0,0,113,1800,38,1958
5143,7,1,0,0,114,1801,38,1961
5144,7,1,0,0,113,1798,39,1958
5145,7,0,0,0,113,1799,38,1957
5146,7,0,0,0,113,1802,40,1962
5147,7,0,0,0,113,1801,39,1960
5148,7,0,0,0,113,1802,39,1961
5149,7,0,0,0,112,1799,38,1956
5150,7,1,0,0,113,1800,38,1959
5151,7,0,0,144,113,1801,39,2104
5152,7,1,0,131,113,1799,39,2090
5153,7,0,0,127,112,1799,38,2083
5154,7,1,0,126,112,1805,38,2089
5155,7,0,0,125,112,1802,38,2084
5156,7,0,0,124,114,1807,38,2090
5157,7,0,0,125,114,1806,39,2091
5158,7,1,0,126,112,1802,38,2086
5159,7,1,0,127,106,175,38,454
5160,7,2,0,127,106,1,38,281
5161,7,0,0,7,106,1,38,159
5162,7,0,0,7,106,1,38,159
5163,7,0,0,7,106,1,38,159
5164,7,0,0,7,106,1,38,159
5165,7,0,0,7,105,1,39,159
5166,7,0,0,7,104,1,38,157
5167,7,0,0,7,103,1,38,156
5168,7,0,0,7,106,1,38,159
5169,7,0,0,7,104,1,38,157
5170,7,0,0,7,104,1,38,157
5171,7,1,0,149,105,1,38,301
5172,7,0,0,137,103,1,38,286
5173,7,0,0,135,103,0,38,283
5174,7,0,0,134,104,1,38,284
5175,7,0,0,133,104,38,38,320
5176,7,0,0,132,104,38,39,320
5177,7,0,0,132,104,38,38,319
5178,7,0,0,131,105,37,38,318
5179,7,0,0,131,105,37,38,318
5180,7,0,0,130,106,36,39,318
5181,7,1,0,130,103,37,39,317
5182,7,0,0,129,104,36,39,315
5183,7,0,0,129,104,37,39,316
5184,7,1,0,132,104,37,38,319
5185,7,1,0,126,104,36,38,312
5186,7,0,0,124,103,38,38,310
5187,7,0,0,122,103,37,38,307
5188,7,0,0,1,104,36,38,186
5189,7,0,0,0,114,1367,38,1526
5190,7,0,0,0,114,1580,38,1739
5191,7,1,0,0,114,1658,38,1818
5192,7,0,0,0,114,1709,39,1869
5193,7,0,0,0,114,1736,39,1896
5194,7,0,0,0,114,1745,39,1905
5195,7,1,0,0,115,1754,38,1915
5196,7,0,0,0,114,1754,38,1913
5197,7,0,0,0,113,1769,39,1928
5198,7,1,0,0,114,1774,38,1934
5199,7,0,0,0,114,1775,38,1934
5200,7,0,0,0,114,1776,38,1935
5201,7,1,0,0,114,1786,38,1946
5202,7,1,0,0,113,1789,38,1948
5203,7,0,0,0,113,1786,39,1945
5204,7,0,0,0,113,1789,38,1947
5205,7,0,0,0,115,1789,38,1949
5206,7,0,0,0,113,1791,38,1949
5207,7,1,0,0,113,1791,38,1950
5208,7,0,0,0,113,1790,38,1948
5209,7,0,0,0,114,1797,38,1956
5210,7,0,0,0,114,1798,38,1957
5211,7,0,0,0,113,1795,38,1953
5212,7,0,0,0,114,1791,39,1951
5213,7,0,0,0,115,1801,38,1961
5214,7,0,0,0,114,1800,38,1959
5215,7,0,0,0,114,1800,38,1959
5216,7,1,0,0,114,1806,38,1966
5217,7,0,0,143,113,1803,38,2104
5218,7,0,0,138,114,1800,38,2097
5219,7,0,0,128,114,1800,39,2088
5220,7,0,0,127,114,1806,39,2093
5221,7,0,0,126,114,1807,38,2092
5222,7,0,0,124,114,1803,39,2087
5223,7,0,0,126,114,1802,38,2087
5224,7,1,0,123,107,1,38,277
5225,7,0,0,123,107,1,38,276
5226,7,1,0,122,106,1,38,275
5227,7,0,0,1,106,1,38,153
5228,7,1,0,0,105,1,38,152
5229,7,0,0,0,106,1,38,152
5230,7,1,0,0,106,1,38,153
5231,7,0,0,0,105,1,39,152
5232,7,0,0,0,105,1,38,151
5233,7,0,0,1,104,1,39,152
5234,7,0,0,0,105,1,39,152
5235,7,0,0,0,104,1,38,150
5236,7,0,0,0,104,1,38,150
5237,7,1,0,0,104,1,38,151
5238,7,1,0,0,105,1,39,153
5239,7,1,0,0,105,38,38,189
5240,7,0,0,0,103,37,39,186
5241,7,1,0,0,104,38,38,188
5242,7,0,0,0,105,37,39,188
5243,7,0,0,0,104,36,38,185
5244,7,1,0,10,104,36,38,196
5245,7,0,0,7,105,37,39,195
5246,7,0,0,0,105,37,38,187
5247,7,1,0,0,104,36,38,186
5248,7,0,0,0,105,37,38,187
5249,7,0,0,0,105,36,38,186
5250,7,1,0,0,105,36,39,188
5251,7,0,0,0,106,36,39,188
5252,7,0,0,0,113,1324,38,1482
5253,7,0,0,1,114,1575,38,1735
5254,7,0,0,1,114,1696,38,1856
5255,7,0,0,0,114,1726,38,1885
5256,7,1,0,146,113,1736,39,2042
5257,7,0,0,138,113,1747,39,2044
5258,7,1,0,128,113,1763,40,2052
5259,7,0,0,127,114,1767,38,2053
5260,7,0,0,126,113,1781,38,2065
5261,7,0,0,125,114,1789,39,2074
5262,7,0,0,124,114,1791,38,2074
5263,7,0,0,125,112,1794,39,2077
5264,6,0,0,122,111,1786,38,2063
5265,7,1,0,121,113,1784,39,2065
5266,7,0,0,0,114,1798,38,1957
5267,7,0,0,0,115,1787,38,1947
5268,7,0,0,0,113,1798,38,1956
5269,7,0,0,0,113,1790,39,1949
5270,7,0,0,0,114,1797,37,1955
5271,7,1,0,0,114,1808,39,1969
5272,7,0,0,0,114,1789,38,1948
5273,7,0,0,0,114,1798,38,1957
5274,7,0,0,1,114,1808,39,1969
5275,7,0,0,0,115,1813,39,1974
5276,7,0,0,0,113,1809,39,1968
5277,7,0,0,0,113,1809,39,1968
5278,7,1,0,0,106,1,38,153
5279,7,0,0,0,107,1,39,154
5280,7,1,0,0,107,0,39,154
5281,7,1,0,0,106,1,38,153
5282,7,1,0,0,106,1,38,153
5283,7,0,0,0,107,1,38,153
5284,7,0,0,1,105,1,39,153
5285,7,1,0,0,106,1,38,153
5286,7,0,0,0,104,1,39,151
5287,7,0,0,1,105,1,38,152
5288,7,0,0,0,106,1,38,152
5289,7,0,0,0,104,1,38,150
5290,7,0,0,0,105,1,38,151
5291,7,0,0,1,105,1,38,152
5292,7,0,0,0,103,1,38,149
5293,7,0,0,0,103,1,38,149
5294,7,0,0,0,105,1,39,152
5295,7,1,0,0,103,1,38,150
5296,7,1,0,0,105,38,38,189
5297,7,0,0,0,104,38,38,187
5298,7,1,0,0,104,37,38,187
5299,7,1,0,0,104,37,38,187
5300,7,1,0,143,104,37,39,331
5301,7,0,0,138,104,38,38,325
5302,7,0,0,129,105,37,39,317
5303,7,1,0,126,104,37,38,313
5304,7,0,0,126,104,36,39,312
5305,7,0,0,130,105,36,39,317
5306,7,0,0,127,103,37,39,313
5307,7,0,0,124,104,36,38,309
5308,7,0,0,123,105,37,39,311
5309,7,0,0,122,104,37,39,309
5310,7,0,0,0,104,36,38,185
5311,7,0,0,0,104,35,39,185
5312,7,0,0,0,105,37,38,187
5313,7,0,0,0,104,37,39,187
5314,7,0,0,0,104,37,39,187
5315,7,0,0,0,104,36,39,186
5316,7,0,0,0,105,37,39,188
5317,7,0,0,0,104,36,39,186
5318,7,0,0,0,104,37,38,186
5319,7,0,0,0,103,37,38,185
5320,7,2,0,0,103,36,38,186
5321,7,0,0,0,104,36,38,185
5322,7,1,0,0,105,37,39,189
5323,7,0,0,0,106,36,39,188
5324,7,1,0,0,106,37,38,189
5325,7,1,0,0,106,37,39,190
5326,7,0,0,7,104,37,39,194
5327,7,0,0,7,106,38,39,197
5328,7,0,0,7,105,37,38,194
5329,7,0,0,7,104,37,39,194
5330,7,1,0,7,105,37,39,196
5331,7,1,0,7,104,36,39,194
5332,7,0,0,7,107,36,39,196
5333,7,0,0,150,106,37,38,338
5334,7,1,0,138,104,37,38,325
5335,7,0,0,137,115,1352,38,1649
5336,7,0,0,135,115,1596,38,1891
5337,7,1,0,134,114,1670,38,1964
5338,7,1,0,133,114,1713,38,2006
5339,7,0,0,132,114,1738,38,2029
5340,7,0,0,132,114,1747,38,2038
5341,7,0,0,132,114,1749,39,2041
5342,7,0,0,131,115,1752,38,2043
5343,7,1,0,131,114,1767,39,2059
5344,7,1,0,130,115,1773,38,2064
5345,7,0,0,130,114,1773,38,2062
5346,7,0,0,129,115,1777,38,2066
5347,7,0,0,129,114,1777,38,2065
5348,7,1,0,129,114,1781,39,2071
5349,7,1,0,128,114,1787,38,2075
5350,7,0,0,128,112,1795,37,2079
5351,7,0,0,8,113,1801,38,1967
5352,7,1,0,8,113,1790,38,1957
5353,7,1,0,11,114,1784,38,1955
5354,7,0,0,1,113,1790,38,1949
5355,7,0,0,1,114,1806,38,1966
5356,7,0,0,1,113,1794,38,1953
5357,7,0,0,1,113,1798,38,1957
5358,7,0,0,1,113,1799,38,1958
5359,7,0,0,0,115,1801,38,1961
5360,7,1,0,0,108,1,39,156
5361,7,0,0,0,106,1,38,152
5362,7,1,0,1,107,0,38,154
5363,7,0,0,1,106,1,38,153
5364,7,0,0,0,106,1,38,152
5365,7,0,0,146,106,1,39,299
5366,7,0,0,131,106,1,39,284
5367,7,0,0,128,106,0,38,279
5368,7,1,0,127,106,1,39,281
5369,7,0,0,125,106,0,39,277
5370,7,1,0,125,105,0,38,276
5371,7,0,0,123,105,0,38,273
5372,7,1,0,203,106,1,38,356
5373,7,0,0,122,105,1,39,274
5374,7,0,0,0,106,1,39,153
5375,7,0,0,0,105,1,39,152
5376,7,0,0,0,104,1,38,150
5377,7,1,0,0,106,1,39,154
5378,7,0,0,0,103,41,38,189
5379,7,1,0,0,104,37,38,187
5380,7,1,0,0,104,37,39,188
5381,7,1,0,0,104,36,38,186
5382,7,0,0,0,105,37,38,187
5383,7,0,0,0,104,37,39,187
5384,7,0,0,0,104,37,38,186
5385,7,0,0,0,104,37,39,187
5386,7,1,0,0,105,36,38,187
5387,7,1,0,0,103,36,39,186
5388,7,0,0,0,104,36,37,184
5389,7,0,0,0,103,36,38,184
5390,7,0,0,0,104,36,39,186
5391,7,0,0,0,105,37,38,187
5392,7,0,0,0,104,37,39,187
5393,7,0,0,0,104,36,38,185
5394,7,0,0,1,103,36,38,185
5395,7,0,0,0,104,38,38,187
5396,7,0,0,1,104,37,38,187
5397,7,0,0,1,104,36,38,186
5398,7,1,0,0,104,37,39,188
5399,7,0,0,1,104,36,40,188
5400,7,0,0,0,104,37,38,186
5401,7,1,0,0,105,37,39,189
5402,7,0,0,1,105,38,38,189
5403,7,0,0,0,104,37,38,186
5404,7,0,0,0,103,36,38,184
5405,7,0,0,0,104,37,38,186
5406,7,0,0,0,105,37,38,187
5407,7,0,0,0,105,37,38,187
5408,7,0,0,143,104,37,38,329
5409,7,0,0,138,105,35,39,324
5410,7,1,0,130,106,36,38,318
5411,7,1,0,127,104,36,38,313
5412,7,0,0,127,105,36,38,313
5413,7,0,0,128,106,37,38,316
5414,7,0,0,127,105,36,39,314
5415,7,0,0,125,105,36,38,311
5416,7,1,0,123,106,37,38,312
5417,7,0,0,122,106,37,38,310
5418,7,0,0,0,106,37,38,188
5419,7,0,0,1,106,38,38,190
5420,7,0,0,0,105,37,38,187
5421,7,0,0,1,106,37,39,190
5422,7,0,0,80,105,36,38,266
5423,7,0,0,0,105,36,39,187
5424,7,1,0,84,103,37,38,270
5425,7,1,0,0,105,37,39,189
5426,7,0,0,0,105,36,39,187
5427,7,0,0,7,104,37,38,193
5428,7,0,0,7,104,36,38,192
5429,7,0,0,7,104,36,39,193
5430,7,1,0,7,106,36,38,195
5431,7,0,0,7,103,36,38,191
5432,7,1,0,7,104,37,39,195
5433,7,1,0,7,107,36,38,196
5434,7,0,0,7,104,37,38,193
5435,7,1,0,153,104,37,39,341
5436,7,0,0,144,104,37,39,331
5437,7,0,0,137,105,37,38,324
5438,7,0,0,136,106,35,38,322
5439,7,0,0,135,104,36,39,321
5440,7,1,0,134,104,37,39,322
5441,7,0,0,134,104,35,38,318
5442,7,0,0,133,104,36,38,318
5443,7,0,0,132,104,35,39,317
5444,7,0,0,132,104,36,39,318
5445,7,1,0,132,105,36,38,319
5446,7,0,0,132,104,37,38,318
5447,7,1,0,130,104,36,38,316
5448,7,1,0,130,105,37,39,319
5449,7,0,0,129,104,35,38,313
5450,7,1,0,129,104,37,38,316
5451,8,0,0,129,106,36,38,317
5452,7,0,0,129,105,36,39,316
5453,7,0,0,128,105,37,39,316
5454,7,0,0,7,104,37,38,193
5455,7,1,0,7,105,36,39,195
5456,7,1,0,10,104,36,39,197
5457,7,0,0,0,104,36,39,186
5458,7,0,0,0,103,37,39,186
5459,7,0,0,0,104,37,38,186
5460,7,0,0,0,105,36,38,186
5461,8,0,0,1,104,36,38,187
5462,7,0,0,1,105,35,38,186
5463,7,0,0,0,104,36,38,185
5464,7,0,0,0,103,36,38,184
5465,7,0,0,0,104,36,38,185
5466,7,0,0,0,105,36,38,186
5467,7,0,0,145,104,35,38,329
5468,7,0,0,140,103,36,38,324
5469,7,0,0,128,103,36,38,312
5470,7,2,0,126,105,36,38,314
5471,8,2,0,126,105,37,39,317
5472,7,0,0,125,103,35,39,309
5473,7,1,0,123,103,35,38,307
5474,7,0,0,122,104,37,39,309
5475,7,0,0,122,104,35,38,306
5476,7,1,0,121,104,35,38,306
5477,7,0,0,0,104,36,39,186
5478,7,1,0,1,104,35,38,186
5479,7,0,0,0,104,36,39,186
5480,7,0,0,0,104,38,38,187
5481,7,1,0,0,104,35,38,185
5482,7,0,0,1,104,36,39,187
5483,7,0,0,0,104,37,39,187
5484,7,0,0,0,104,35,39,185
5485,7,0,0,0,104,36,38,185
5486,7,1,0,0,105,36,38,187
5487,7,0,0,1,104,36,39,187
5488,7,0,0,0,103,36,38,184
5489,7,0,0,0,104,37,39,187
5490,7,0,0,0,105,36,39,187
5491,7,0,0,0,104,35,39,185
5492,7,0,0,1,104,36,38,186
5493,7,0,0,1,104,37,39,188
5494,8,1,0,1,105,37,39,191
5495,8,0,0,1,105,38,39,191
5496,8,0,0,1,105,36,38,188
5497,8,1,0,1,105,35,39,189
5498,8,0,0,1,105,38,39,191
5499,8,0,0,1,105,37,39,190
5500,7,0,0,1,103,37,38,186
5501,7,0,0,0,104,36,38,185
5502,7,0,0,0,104,36,38,185
5503,7,2,0,0,104,36,39,188
5504,7,0,0,0,114,1378,39,1538
5505,7,0,0,0,115,1593,39,1754
5506,7,0,0,1,114,1672,38,1832
5507,7,0,0,0,114,1712,38,1871
5508,7,0,0,0,113,1730,38,1888
5509,7,0,0,1,115,1730,38,1891
5510,7,0,0,0,114,1746,38,1905
5511,7,1,0,144,113,1762,39,2066
5512,7,0,0,133,113,1769,38,2060
5513,7,2,0,127,113,1776,38,2063
5514,7,0,0,128,113,1779,38,2065
5515,7,0,0,127,113,1782,38,2067
5516,7,0,0,127,114,1791,39,2078
5517,7,0,0,129,113,1791,38,2078
5518,7,1,0,125,115,1789,39,2076
5519,7,0,0,123,115,1800,38,2083
5520,7,0,0,122,114,1794,39,2076
5521,7,0,0,1,113,1814,39,1974
5522,7,0,0,1,114,1816,39,1977
5523,7,0,0,0,114,1816,38,1975
5524,7,1,0,1,107,1,38,155
5525,7,0,0,0,107,1,38,153
5526,7,0,0,0,106,1,38,152
5527,7,1,0,0,106,1,39,154
5528,7,0,0,0,107,1,37,152
5529,7,0,0,1,106,1,39,154
5530,7,1,0,0,105,1,38,152
5531,7,0,0,0,106,1,38,152
5532,7,0,0,0,104,1,38,150
5533,7,0,0,1,104,1,38,151
5534,7,0,0,0,106,1,38,152
5535,7,1,0,0,104,1,38,151
5536,7,0,0,0,105,1,39,152
5537,7,0,0,1,104,0,39,151
5538,7,0,0,0,104,1,38,150
5539,7,1,0,1,105,1,38,153
5540,7,0,0,0,104,1,38,150
5541,7,1,0,0,104,38,39,189
5542,7,0,0,1,104,38,38,188
5543,7,0,0,1,105,38,38,189
5544,7,1,0,0,106,37,39,190
5545,7,0,0,1,105,38,38,189
5546,7,1,0,0,106,37,39,190
5547,7,0,0,1,105,36,38,187
5548,7,1,0,1,104,38,38,189
5549,7,0,0,1,105,38,38,189
5550,7,0,0,0,106,37,38,188
5551,7,0,0,0,104,37,39,187
5552,7,0,0,0,106,37,38,188
5553,7,0,0,147,105,37,38,334
5554,7,1,0,134,106,36,38,322
5555,7,0,0,212,105,38,38,400
5556,7,1,0,127,105,36,39,315
5557,7,1,0,207,104,37,38,394
5558,7,1,0,127,105,36,38,314
5559,7,0,0,128,104,36,38,313
5560,7,1,0,128,104,38,38,316
5561,7,0,0,130,105,37,38,317
5562,7,0,0,130,104,36,38,315
5563,7,0,0,130,104,37,39,317
5564,7,0,0,129,104,37,38,315
5565,7,0,0,7,103,38,39,194
5566,7,0,0,7,105,38,38,195
5567,7,0,0,7,104,38,38,194
5568,7,1,0,7,104,37,38,194
5569,7,0,0,7,104,37,39,194
5570,7,0,0,7,104,38,38,194
5571,7,0,0,7,104,37,38,193
5572,7,1,0,7,103,36,38,192
5573,7,0,0,7,104,36,38,192
5574,7,0,0,149,104,37,39,336
5575,7,0,0,137,104,36,38,322
5576,7,0,0,137,104,38,38,324
5577,7,2,0,136,104,37,38,324
5578,7,0,0,134,103,37,38,319
5579,7,0,0,134,106,37,38,322
5580,7,0,0,133,104,37,39,320
5581,7,0,0,132,103,37,39,318
5582,7,0,0,132,104,37,38,318
5583,7,0,0,132,105,38,39,321
5584,7,0,0,131,105,36,38,317
5585,7,0,0,130,104,38,39,318
5586,7,0,0,129,104,38,38,316
5587,7,0,0,130,104,37,39,317
5588,7,0,0,129,104,37,39,316
5589,7,0,0,128,103,36,38,312
5590,7,0,0,130,104,36,38,315
5591,7,0,0,128,105,37,38,315
5592,7,0,0,128,105,35,39,314
5593,7,0,0,7,104,37,38,193
5594,7,0,0,7,104,37,38,193
5595,7,1,0,7,105,38,38,196
5596,7,0,0,0,105,38,39,189
5597,7,0,0,0,104,38,39,188
5598,7,0,0,1,104,37,39,188
5599,7,0,0,0,104,36,38,185
5600,7,0,0,0,104,37,38,186
5601,7,0,0,0,105,36,39,187
5602,7,1,0,0,105,36,38,187
5603,7,0,0,0,104,37,38,186
5604,7,0,0,0,104,37,38,186
5605,7,0,0,144,105,38,39,333
5606,7,1,0,130,104,36,38,316
5607,7,0,0,129,105,37,39,317
5608,7,1,0,127,104,37,38,314
5609,7,1,0,125,104,37,38,312
5610,7,0,0,125,104,37,38,311
5611,7,0,0,123,104,37,38,309
5612,7,0,0,122,104,37,38,308
5613,7,0,0,122,104,36,39,308
5614,7,0,0,0,104,36,39,186
5615,7,0,0,0,104,38,39,188
5616,7,0,0,0,104,38,39,188
5617,7,0,0,0,104,37,39,187
5618,7,0,0,0,104,37,39,187
5619,7,1,0,0,104,36,38,186
5620,7,0,0,0,104,38,39,188
5621,7,1,0,0,104,37,38,187
5622,7,0,0,0,104,37,39,187
5623,7,0,0,0,104,36,38,185
5624,7,0,0,0,105,38,38,188
5625,7,0,0,0,104,37,39,187
5626,7,1,0,0,104,36,39,187
5627,7,1,0,0,104,35,38,185
5628,7,0,0,0,104,37,38,186
5629,7,0,0,0,104,36,39,186
5630,7,0,0,0,104,36,39,186
5631,7,0,0,0,104,38,39,188
5632,7,0,0,0,104,37,38,186
5633,7,0,0,1,105,36,38,187
5634,7,0,0,0,104,36,39,186
5635,7,0,0,0,104,37,38,186
5636,7,0,0,0,103,36,38,184
5637,7,1,0,0,104,36,39,187
5638,7,0,0,0,104,36,39,186
5639,7,0,0,0,103,36,39,185
5640,7,1,0,0,105,37,39,189
5641,7,0,0,0,104,36,39,186
5642,7,0,0,0,104,36,39,186
5643,7,0,0,0,104,36,38,185
5644,7,0,0,0,104,36,38,185
5645,7,0,0,0,104,36,38,185
5646,7,0,0,0,104,37,38,186
5647,7,0,0,0,104,37,39,187
5648,7,0,0,142,104,38,38,329
5649,7,1,0,131,104,37,38,318
5650,7,0,0,127,105,37,38,314
5651,7,0,0,126,105,36,38,312
5652,7,0,0,126,104,36,39,312
5653,7,1,0,125,104,36,38,311
5654,7,1,0,124,105,36,38,311
5655,7,0,0,123,104,38,38,310
5656,7,1,0,128,104,36,39,315
5657,7,1,0,0,104,36,39,187
5658,7,0,0,0,104,37,38,186
5659,7,0,0,0,105,37,39,188
5660,7,0,0,0,104,37,38,186
5661,7,0,0,0,104,36,38,185
5662,7,0,0,0,104,36,39,186
5663,7,0,0,0,104,37,38,186
5664,7,1,0,0,104,36,38,186
5665,7,0,0,0,104,38,38,187
5666,7,1,0,0,104,37,39,188
5667,7,0,0,0,104,37,38,186
5668,7,0,0,0,104,38,38,187
5669,7,1,0,0,104,36,38,186
5670,7,1,0,0,104,35,38,185
5671,7,0,0,0,105,37,39,188
5672,7,1,0,0,105,38,39,190
5673,7,0,0,0,104,37,38,186
5674,7,1,0,0,104,38,39,189
5675,7,1,0,0,105,37,38,188
5676,7,0,0,0,104,36,38,185
5677,7,1,0,0,104,36,38,186
5678,7,0,0,0,104,37,39,187
5679,7,0,0,0,104,38,39,188
5680,7,1,0,0,104,37,39,188
5681,7,0,0,0,104,37,38,186
5682,7,0,0,1,104,36,38,186
5683,7,0,0,0,104,37,39,187
5684,7,0,0,0,104,36,38,185
5685,7,0,0,0,104,37,39,187
5686,7,0,0,0,105,37,39,188
5687,7,0,0,0,104,36,39,186
5688,7,1,0,0,104,35,39,186
5689,7,0,0,143,104,37,39,330
5690,7,1,0,130,104,37,38,317
5691,7,1,0,127,105,36,39,315
5692,7,1,0,127,104,38,38,315
5693,7,0,0,127,105,36,39,314
5694,7,1,0,125,104,37,39,313
5695,7,0,0,124,104,35,38,308
5696,7,0,0,124,113,1519,38,1801
5697,7,0,0,122,115,1665,38,1947
5698,7,0,0,0,114,1697,39,1857
5699,7,0,0,1,114,1721,39,1882
5700,7,0,0,0,115,1738,38,1898
5701,7,0,0,0,115,1763,39,1924
5702,7,0,0,0,115,1784,39,1945
5703,7,1,0,0,114,1785,38,1945
5704,7,1,0,0,114,1790,38,1950
5705,7,0,0,0,114,1798,39,1958
5706,7,0,0,0,115,1797,38,1957
5707,7,0,0,0,114,1805,38,1964
5708,7,0,0,0,114,1793,39,1953
5709,7,0,0,0,113,1807,38,1965
5710,7,0,0,0,114,1811,38,1970
5711,7,0,0,0,113,1810,38,1968
5712,7,1,0,0,114,1815,38,1975
5713,7,1,0,1,108,1,38,156
5714,7,1,0,0,106,1,38,153
5715,7,2,0,0,106,1,39,155
5716,7,0,0,10,105,1,39,162
5717,7,0,0,10,106,1,39,163
5718,7,0,0,0,106,1,39,153
5719,7,1,0,0,106,1,39,154
5720,7,0,0,0,104,1,39,151
5721,7,1,0,0,104,1,39,152
5722,7,0,0,0,104,1,39,151
5723,7,0,0,0,105,1,39,152
5724,7,0,0,0,103,1,39,150
5725,7,0,0,0,104,1,38,150
5726,7,0,0,0,103,0,38,148
5727,7,0,0,0,104,1,38,150
5728,7,1,0,143,104,1,38,294
5729,7,0,0,130,104,1,38,280
5730,7,0,0,128,104,0,38,277
5731,7,0,0,128,105,1,39,280
5732,7,1,0,125,104,37,38,312
5733,7,0,0,125,103,38,38,311
5734,7,0,0,123,103,36,38,307
5735,7,0,0,123,105,37,38,310
5736,7,0,0,122,107,37,38,311
5737,7,1,0,0,104,36,39,187
5738,7,0,0,0,104,37,38,186
5739,7,0,0,0,106,38,38,189
5740,7,2,0,0,104,36,38,187
5741,7,1,0,0,104,36,39,187
5742,7,0,0,0,105,37,38,187
5743,7,0,0,1,104,36,38,186
5744,7,1,0,0,104,37,38,187
5745,7,0,0,10,104,37,39,197
5746,7,0,0,7,104,37,39,194
5747,7,1,0,7,104,37,38,194
5748,7,0,0,7,103,36,38,191
5749,7,0,0,7,104,37,38,193
5750,7,1,0,7,104,35,38,192
5751,7,1,0,7,104,38,39,196
5752,7,0,0,7,103,37,37,191
5753,7,1,0,7,104,37,38,194
5754,7,1,0,7,104,37,39,195
5755,7,5,0,151,105,36,38,342
5756,7,5,0,140,104,36,38,330
5757,329,4610,0,138,104,35,38,5254
5758,329,4633,0,136,104,36,38,5276
5759,7,4631,0,135,104,36,38,4951
5760,7,4600,0,135,104,37,39,4922
5761,7,4612,0,134,104,37,38,4932
5762,7,4573,0,133,103,36,38,4890
5763,7,4552,0,132,104,37,38,4870
5764,7,4578,0,131,104,37,38,4895
5765,7,4543,0,131,104,36,38,4859
5766,7,4599,0,131,103,36,38,4914
5767,7,4548,0,131,104,36,38,4864
5768,7,4540,0,131,104,37,38,4857
5769,7,4573,0,130,105,35,38,4888
5770,7,4575,0,129,104,36,39,4890
5771,7,4553,0,128,104,35,39,4866
5772,7,4554,0,128,104,36,38,4867
5773,7,4525,0,128,103,37,39,4839
5774,7,4521,0,128,103,37,39,4835
5775,7,4518,0,10,104,37,39,4715
5776,7,4501,0,0,103,37,39,4687
5777,7,4530,0,1,103,36,39,4716
5778,7,4496,0,1,104,36,39,4683
5779,7,4508,0,0,103,36,38,4692
5780,7,4506,0,1,103,35,37,4689
5781,7,4514,0,1,103,35,38,4698
5782,7,4508,0,1,103,35,38,4692
5783,7,4514,0,1,104,36,38,4700
5784,7,4526,0,1,104,36,38,4712
5785,7,4553,0,0,103,35,38,4736
5786,7,4599,0,1,104,36,38,4785
5787,7,4567,0,0,104,36,38,4752
5788,7,4556,0,1,104,37,38,4743
5789,7,244,0,0,104,37,39,431
5790,7,244,0,1,104,36,39,431
5791,7,237,0,151,104,38,38,575
5792,7,251,0,138,105,36,38,575
5793,7,249,0,128,104,36,39,563
5794,7,247,0,127,104,36,38,559
5795,7,252,0,125,104,35,38,561
5796,7,250,0,125,104,36,38,560
5797,7,253,0,203,103,36,38,640
5798,7,251,0,124,103,37,38,560
5799,7,257,0,124,104,36,38,566
5800,7,0,0,0,105,37,38,187
5801,7,1,0,0,104,36,38,186
5802,7,0,0,0,104,36,38,185
5803,7,0,0,0,104,36,38,185
5804,7,2,0,0,104,37,38,188
5805,7,0,0,0,104,36,38,185
5806,7,0,0,1,104,36,39,187
5807,7,0,0,0,104,37,38,186
5808,7,0,0,0,104,37,38,186
5809,7,1,0,0,106,36,39,189
5810,7,1,0,0,104,37,40,189
5811,7,0,0,0,104,35,39,185
5812,7,0,0,0,105,37,39,188
5813,8,1,0,1,105,37,39,191
5814,7,0,0,0,105,36,39,187
5815,7,0,0,0,104,35,39,185
5816,7,0,0,0,104,35,39,185
5817,7,0,0,0,104,35,38,184
5818,7,1,0,1,105,35,38,187
5819,7,0,0,1,104,36,39,187
5820,7,0,0,1,104,36,39,187
5821,7,0,0,0,104,37,38,186
5822,7,1,0,0,105,36,39,188
5823,7,0,0,0,105,38,38,188
5824,7,0,0,0,104,36,39,186
5825,7,1,0,0,104,35,38,185
5826,7,0,0,0,104,36,38,185
5827,7,0,0,0,105,36,39,187
5828,7,0,0,0,104,36,38,185
5829,7,0,0,0,104,36,39,186
5830,7,0,0,0,103,36,38,184
5831,7,1,0,1,103,36,39,187
5832,7,1,0,0,104,37,39,188
5833,7,0,0,147,104,36,38,332
5834,7,0,0,135,104,36,38,320
5835,7,1,0,132,104,35,38,317
5836,7,1,0,130,106,36,38,318
5837,7,0,0,128,105,37,38,315
5838,7,0,0,127,103,36,39,312
5839,7,0,0,124,104,36,38,309
5840,7,0,0,124,104,36,38,309
5841,7,0,0,125,105,36,39,312
5842,7,0,0,123,106,37,38,311
5843,7,0,0,0,104,35,38,184
5844,7,0,0,1,104,36,38,186
5845,7,1,0,0,105,37,38,188
5846,7,0,0,0,104,36,39,186
5847,7,0,0,1,104,37,38,187
5848,7,1,0,0,104,38,38,188
5849,7,0,0,0,104,36,39,186
5850,7,0,0,0,104,36,39,186
5851,7,0,0,0,104,36,39,186
5852,7,0,0,0,105,37,39,188
5853,7,0,0,0,103,36,38,184
5854,7,0,0,0,104,37,38,186
5855,7,1,0,0,103,36,39,186
5856,7,0,0,0,104,36,39,186
5857,7,0,0,0,104,35,38,184
5858,7,0,0,0,104,37,38,186
5859,7,0,0,1,104,36,38,186
5860,7,0,0,0,103,37,39,186
5861,7,0,0,1,104,36,38,186
5862,7,0,0,7,103,36,38,191
5863,7,0,0,7,104,37,38,193
5864,7,1,0,7,104,37,38,194
5865,7,0,0,157,104,37,38,343
5866,7,0,0,143,104,36,38,328
5867,7,0,0,139,104,36,39,325
5868,7,1,0,138,103,37,38,324
5869,7,0,0,139,103,37,39,325
5870,7,0,0,138,104,36,38,323
5871,7,0,0,138,104,37,38,324
5872,7,0,0,138,103,36,38,322
5873,7,0,0,136,104,37,38,322
5874,7,0,0,136,105,36,38,322
5875,7,1,0,134,104,36,38,320
5876,7,0,0,134,103,36,39,319
5877,7,0,0,133,104,37,39,320
5878,7,0,0,133,105,36,38,319
5879,7,1,0,133,104,36,39,320
5880,7,0,0,132,104,36,39,318
5881,7,0,0,132,104,37,38,318
5882,7,0,0,132,105,37,39,320
5883,7,0,0,132,104,36,39,318
5884,7,0,0,132,104,36,39,318
5885,7,0,0,134,103,37,40,321
5886,7,1,0,133,104,36,39,320
5887,7,0,0,132,113,1252,39,1543
5888,7,0,0,131,374,2128,39,2679
5889,7,0,0,131,372,2252,39,2801
5890,7,2,0,131,368,2323,39,2870
5891,7,0,0,129,370,2343,40,2889
5892,7,0,0,129,369,2351,39,2895
5893,7,1,0,129,369,2362,39,2907
5894,7,0,0,128,367,2370,40,2912
5895,7,0,0,128,363,2376,39,2913
5896,7,0,0,128,367,2390,39,2931
5897,7,1,0,128,371,2393,39,2939
5898,7,0,0,129,363,2394,39,2932
5899,7,0,0,128,371,2398,39,2943
5900,7,1,0,7,369,2396,39,2819
5901,7,0,0,6,367,2402,38,2820
5902,7,0,0,7,374,2404,40,2832
5903,7,0,0,6,366,2406,39,2824
5904,7,1,0,7,373,2409,38,2835
5905,7,0,0,6,369,2409,39,2830
5906,7,0,0,7,370,2409,39,2832
5907,7,0,0,0,370,2416,39,2832
5908,7,1,0,0,363,2412,39,2822
5909,7,0,0,152,367,2408,39,2973
5910,6,0,0,136,369,2420,39,2970
5911,7,1,0,129,371,2410,39,2957
5912,7,0,0,128,362,2422,39,2958
5913,7,1,0,127,361,2422,40,2958
5914,7,0,0,126,168,1,39,341
5915,7,0,0,127,105,1,39,279
5916,7,1,0,126,104,1,40,279
5917,7,0,0,123,103,1,38,272
5918,7,1,0,122,103,1,39,273
5919,7,1,0,122,103,1,39,273
5920,7,0,0,121,103,1,38,270
5921,7,0,0,0,103,0,39,149
5922,7,0,0,0,103,1,39,150
5923,7,0,0,0,103,1,39,150
5924,7,0,0,0,102,1,39,149
5925,7,0,0,0,102,1,39,149
5926,7,0,0,0,103,1,39,150
5927,7,0,0,0,103,1,39,150
5928,7,0,0,0,104,1,39,151
5929,7,0,0,1,104,1,38,151
5930,7,1,0,0,102,41,39,190
5931,7,0,0,0,102,38,39,186
5932,7,1,0,0,103,37,39,187
5933,7,0,0,0,102,37,40,186
5934,7,0,0,0,102,37,39,185
5935,7,0,0,0,102,36,39,184
5936,7,1,0,0,103,36,38,185
5937,7,1,0,1,103,37,38,187
5938,7,0,0,0,103,36,39,185
5939,7,0,0,0,102,36,39,184
5940,7,0,0,0,102,37,39,185
5941,7,0,0,0,103,36,39,185
5942,7,0,0,0,113,1544,38,1702
5943,7,0,0,0,114,1705,37,1863
5944,7,0,0,0,113,1762,39,1921
5945,7,0,0,0,113,1747,39,1906
5946,7,0,0,0,113,1753,38,1911
5947,7,0,0,0,112,1757,39,1915
5948,7,0,0,0,112,1777,38,1934
5949,7,1,0,0,113,1784,38,1943
5950,7,0,0,0,114,1782,39,1942
5951,7,0,0,0,112,1782,38,1939
5952,7,0,0,0,112,1793,38,1950
5953,7,0,0,141,112,1798,38,2096
5954,7,0,0,138,112,1801,38,2096
5955,7,0,0,128,112,1801,38,2086
5956,7,0,0,127,113,1798,38,2083
5957,7,0,0,127,112,1802,38,2086
5958,7,0,0,124,112,1810,38,2091
5959,7,1,0,124,112,1809,38,2091
5960,7,0,0,123,113,1811,38,2092
5961,7,0,0,122,113,1813,38,2093
5962,7,0,0,122,113,1816,38,2096
5963,7,0,0,120,112,1815,38,2092
5964,7,0,0,0,113,1814,39,1973
5965,7,0,0,0,112,1819,39,1977
5966,7,0,0,0,113,1818,38,1976
5967,7,0,0,10,113,1822,38,1990
5968,7,1,0,0,112,1816,38,1974
5969,7,0,0,0,114,1824,39,1984
5970,7,0,0,0,113,1826,38,1984
5971,7,0,0,0,106,1,39,153
5972,7,1,0,0,107,1,38,154
5973,7,0,0,0,107,0,38,152
5974,7,1,0,0,106,1,39,154
5975,7,0,0,0,106,1,39,153
5976,7,0,0,0,107,1,38,153
5977,7,0,0,0,105,1,38,151
5978,7,0,0,0,106,1,38,152
5979,7,0,0,0,106,1,38,152
5980,7,0,0,0,106,1,38,152
5981,7,0,0,0,106,1,38,152
5982,7,0,0,0,106,1,38,152
5983,7,0,0,1,105,1,38,152
5984,7,0,0,0,105,1,38,151
5985,7,0,0,0,104,1,39,151
5986,7,1,0,0,106,1,39,154
5987,7,1,0,0,105,0,39,152
5988,7,0,0,0,105,41,38,191
5989,7,0,0,0,105,37,38,187
5990,7,1,0,0,106,36,38,188
5991,7,0,0,141,105,36,39,328
5992,7,0,0,140,104,37,38,326
5993,7,0,0,128,105,36,38,314
5994,7,0,0,127,106,37,38,315
5995,7,2,0,127,106,36,38,316
5996,7,0,0,125,106,36,39,313
5997,7,1,0,124,105,35,39,311
5998,7,0,0,123,106,36,38,310
5999,7,0,0,122,107,36,38,310
6000,7,0,0,122,104,36,38,307
6001,7,0,0,0,106,37,38,188
6002,7,0,0,0,105,36,39,187
6003,7,0,0,7,105,36,39,194
6004,7,0,0,7,106,36,38,194
6005,7,0,0,7,106,35,38,193
6006,7,0,0,7,105,36,38,193
6007,7,0,0,7,106,37,39,196
6008,7,1,0,7,105,36,38,194
6009,7,1,0,7,105,36,39,195
6010,7,1,0,7,105,36,38,194
6011,7,1,0,7,105,37,39,196
6012,7,0,0,7,107,36,39,196
6013,7,1,0,7,106,37,38,196
6014,7,1,0,155,105,37,38,343
6015,7,1,0,139,104,36,38,325
6016,7,0,0,136,104,37,38,322
6017,7,1,0,135,104,37,38,322
6018,7,0,0,134,105,35,39,320
6019,7,1,0,135,105,36,38,322
6020,7,9,0,134,114,1420,39,1723
6021,7,6,0,132,115,1639,38,1937
6022,7,5,0,132,114,1729,39,2026
6023,7,4616,0,131,114,1730,38,6636
6024,7,4600,0,130,113,1746,38,6634
6025,7,4615,0,130,106,1,39,4898
6026,7,4642,0,131,106,1,38,4925
6027,7,4610,0,131,107,1,39,4895
6028,7,4633,0,129,106,1,39,4915
6029,7,4604,0,129,106,0,38,4884
6030,7,4620,0,128,107,1,38,4901
6031,7,4623,0,128,106,0,38,4902
6032,7,4593,0,127,106,1,38,4872
6033,7,4578,0,124,106,1,39,4855
6034,7,4597,0,122,106,1,39,4872
6035,7,4609,0,1,106,1,39,4763
6036,7,4597,0,0,106,1,40,4751
6037,7,250,0,0,105,38,38,438
6038,7,4581,0,0,106,37,39,4770
6039,7,4602,0,1,106,37,39,4792
6040,7,4608,0,0,104,38,38,4795
6041,7,4620,0,0,107,37,39,4810
6042,7,4593,0,0,106,36,38,4780
6043,6,4589,0,1,103,37,39,4775
6044,7,4620,0,1,104,38,39,4809
6045,7,4621,0,0,104,38,38,4808
6046,7,4552,0,0,104,37,39,4739
6047,7,4541,0,0,106,35,39,4728
6048,7,4566,0,0,105,37,38,4753
6049,7,246,0,0,104,37,38,432
6050,7,242,0,0,106,37,38,430
6051,7,4540,0,1,104,37,39,4728
6052,7,4566,0,1,106,36,38,4754
6053,7,239,0,0,106,37,39,428
6054,7,4604,0,1,105,36,39,4792
6055,331,4584,0,0,106,36,39,5096
6056,329,4552,0,0,106,36,228,5251
6057,329,4565,0,0,105,37,200,5236
6058,331,252,0,0,107,37,205,932
6059,329,246,0,0,106,38,215,934
6060,328,4926,0,0,107,36,205,5602
6061,327,4580,0,0,106,36,371,5420
6062,328,4592,0,0,106,36,261,5323
6063,332,253,0,0,106,36,284,1011
6064,331,243,0,142,106,37,255,1114
6065,332,242,0,129,106,37,348,1194
6066,333,249,0,127,106,37,218,1070
6067,332,254,0,126,106,37,218,1073
6068,333,247,0,124,106,37,294,1141
6069,328,243,0,125,106,36,213,1051
6070,327,249,0,123,105,36,263,1103
6071,327,247,0,122,105,36,244,1081
6072,327,259,0,121,106,36,224,1073
6073,328,253,0,120,106,37,231,1075
6074,329,250,0,0,106,36,221,942
6075,329,1,0,0,106,36,263,735
6076,330,0,0,0,106,37,233,706
6077,331,0,0,0,106,36,213,686
6078,330,0,0,0,106,36,264,736
6079,331,0,0,0,106,36,381,854
6080,331,0,0,0,106,36,252,725
6081,329,1,0,0,106,36,251,723
6082,332,0,0,0,106,37,255,730
6083,332,1,0,0,106,36,364,839
6084,333,0,0,0,107,36,226,702
6085,332,0,0,0,107,36,226,701
6086,334,0,0,0,106,37,324,801
6087,334,0,0,0,107,36,242,719
6088,335,0,0,0,107,36,254,732
6089,332,0,0,0,106,36,258,732
6090,332,1,0,0,106,36,226,701
6091,331,0,0,10,106,36,336,819
6092,331,0,0,10,107,37,341,826
6093,329,0,0,0,106,36,299,770
6094,330,1,0,0,106,36,223,696
6095,330,1,0,0,107,36,248,722
6096,329,0,0,0,107,36,267,739
6097,329,0,0,0,106,37,208,680
6098,331,0,0,0,107,37,248,723
6099,333,0,0,0,107,37,252,729
6100,333,1,0,0,107,37,241,719
6101,332,0,0,0,106,36,269,743
6102,334,1,0,0,107,37,386,865
6103,333,0,0,0,107,37,338,815
6104,334,0,0,146,106,36,242,864
6105,332,0,0,134,108,38,201,813
6106,331,2,0,128,107,35,237,840
6107,332,0,0,127,106,36,227,828
6108,332,0,0,125,107,36,256,856
6109,332,0,0,124,106,37,245,844
6110,333,0,0,123,106,37,236,835
6111,331,1,0,122,107,36,334,931
6112,333,0,0,121,107,36,292,889
6113,333,0,0,121,106,37,235,832
6114,337,0,0,0,106,38,249,730
6115,338,1,0,0,107,36,246,728
6116,338,0,0,0,106,36,236,716
6117,338,0,0,0,106,37,381,862
6118,339,0,0,0,107,37,259,742
6119,339,1,0,0,107,38,229,714
6120,333,1,0,0,107,36,273,750
6121,331,0,0,0,106,36,253,726
6122,333,0,0,0,107,38,253,731
6123,332,0,0,0,106,36,240,714
6124,334,0,0,0,107,36,239,716
6125,334,0,0,0,106,36,219,695
6126,335,0,0,0,107,36,242,720
6127,335,0,0,0,107,37,229,708
6128,335,1,0,0,106,36,237,715
6129,335,0,0,0,106,36,254,731
6130,334,0,0,0,107,36,306,783
6131,335,0,0,0,106,36,227,704
6132,335,1,0,0,106,37,232,711
6133,335,1,0,0,106,38,258,738
6134,336,0,0,0,106,36,203,681
6135,337,0,0,0,107,37,288,769
6136,338,0,0,0,106,37,221,702
6137,336,2,0,0,106,36,238,718
6138,339,0,0,0,107,37,274,757
6139,340,1,0,0,105,36,252,734
6140,338,0,0,0,106,36,259,739
6141,339,0,0,0,106,36,385,866
6142,339,0,0,0,107,37,249,732
6143,335,1,0,0,106,38,228,708
6144,336,0,0,0,106,37,226,705
6145,337,0,0,0,106,38,228,709
6146,338,0,0,0,106,38,225,707
6147,339,0,0,0,107,37,228,711
6148,340,1,0,0,106,36,255,738
6149,337,0,0,891,105,38,254,1625
6150,339,1,0,142,106,36,261,885
6151,333,1,0,129,106,37,242,848
6152,335,0,0,131,106,37,372,981
6153,337,0,0,130,106,37,232,842
6154,338,0,0,130,106,38,255,867
6155,334,0,0,130,106,35,228,833
6156,332,0,0,130,106,37,248,853
6157,334,0,0,128,106,36,262,866
6158,333,1,0,129,106,36,233,838
6159,331,1,0,128,107,37,262,866
6160,332,0,0,128,107,37,229,833
6161,332,0,0,128,106,36,297,899
6162,335,0,0,127,106,37,389,994
6163,336,0,0,127,106,36,211,816
6164,338,0,0,127,106,36,253,860
6165,339,0,0,7,106,38,270,760
6166,338,1,0,7,106,37,248,737
6167,339,0,0,7,106,38,39,529
6168,7,1,0,7,107,37,38,197
6169,7,0,0,7,107,36,39,196
6170,7,0,0,7,106,38,38,196
6171,7,0,0,7,106,37,39,196
6172,7,1,0,7,106,38,39,198
6173,7,0,0,7,106,37,38,195
6174,7,1,0,7,106,37,39,197
6175,7,1,0,140,107,37,38,330
6176,7,0,0,146,106,38,38,335
6177,7,1,0,137,105,37,39,326
6178,7,0,0,136,106,38,38,325
6179,7,0,0,134,106,37,38,322
6180,7,0,0,130,106,38,38,319
6181,7,1,0,129,106,36,38,317
6182,7,0,0,127,106,36,39,315
6183,7,0,0,126,105,37,39,314
6184,7,0,0,127,106,37,38,315
6185,7,0,0,125,106,37,38,313
6186,7,0,0,122,106,37,38,310
6187,7,0,0,123,106,37,39,312
6188,7,0,0,0,104,37,38,186
6189,7,0,0,0,107,38,39,191
6190,7,1,0,0,106,37,39,190
6191,7,0,0,0,106,37,38,188
6192,7,0,0,0,107,37,39,190
6193,7,0,0,0,106,36,39,188
6194,7,0,0,0,106,36,39,188
6195,7,0,0,0,106,38,39,190
6196,7,0,0,0,106,38,39,190
6197,7,0,0,0,106,37,38,188
6198,7,0,0,0,105,38,39,189
6199,7,1,0,0,107,37,38,190
6200,7,0,0,0,106,38,38,189
6201,7,1,0,1,107,38,39,193
6202,7,0,0,0,106,37,39,189
6203,7,1,0,1,107,37,40,193
6204,7,0,0,1,106,37,39,190
6205,7,0,0,0,106,39,38,190
6206,7,1,0,0,106,38,38,190
6207,7,1,0,0,106,37,39,190
6208,7,0,0,0,106,37,39,189
6209,7,0,0,0,106,38,38,189
6210,7,1,0,0,107,37,39,191
6211,7,0,0,0,107,37,38,189
6212,7,0,0,0,106,36,39,188
6213,7,0,0,0,106,36,39,188
6214,7,1,0,0,105,36,38,187
6215,7,0,0,0,106,37,38,188
6216,7,0,0,0,105,36,38,186
6217,7,0,0,0,106,37,39,189
6218,7,2,0,0,106,36,38,189
6219,7,0,0,0,114,999,38,1158
6220,7,0,0,0,113,1545,39,1704
6221,7,0,0,0,114,1655,39,1815
6222,8,0,0,369,115,1664,39,2195
6223,7,0,0,140,113,1710,38,2008
6224,7,2,0,129,115,1722,39,2014
6225,7,0,0,126,114,1734,38,2019
6226,7,1,0,127,114,1750,38,2037
6227,7,0,0,125,115,1757,38,2042
6228,7,0,0,124,115,1744,39,2029
6229,7,0,0,123,114,1766,38,2048
6230,7,0,0,123,114,1762,38,2044
6231,7,1,0,122,115,1778,38,2061
6232,7,1,0,0,115,1774,39,1936
6233,7,0,0,0,115,1779,38,1939
6234,7,0,0,0,114,1779,38,1938
6235,7,0,0,0,113,1784,39,1943
6236,7,0,0,0,114,1778,38,1937
6237,7,1,0,0,113,1782,39,1942
6238,7,0,0,0,115,1785,38,1945
6239,7,0,0,10,114,1787,38,1956
6240,7,0,0,0,115,1787,38,1947
6241,7,0,0,1,114,1787,39,1948
6242,7,0,0,1,113,1794,38,1953
6243,7,1,0,0,114,1793,39,1954
6244,7,0,0,0,114,1794,38,1953
6245,7,0,0,0,115,1792,38,1952
6246,7,1,0,0,115,1802,38,1963
6247,7,1,0,1,115,1797,39,1960
6248,7,1,0,0,114,1795,38,1955
6249,7,1,0,0,114,1805,39,1966
6250,7,0,0,0,115,1805,39,1966
6251,7,0,0,0,114,1806,39,1966
6252,7,1,0,0,115,1802,39,1964
6253,7,0,0,0,108,1,39,155
6254,7,2,0,0,107,1,38,155
6255,7,0,0,1,106,1,39,154
6256,7,0,0,0,107,1,39,154
6257,7,0,0,0,106,1,38,152
6258,7,1,0,0,107,1,38,154
6259,7,1,0,0,108,1,38,155
6260,7,1,0,0,106,1,39,154
6261,7,1,0,0,108,1,39,156
6262,7,1,0,0,107,1,38,154
6263,7,0,0,145,106,1,38,297
6264,7,1,0,132,107,0,38,285
6265,7,0,0,128,106,0,38,279
6266,7,1,0,128,106,1,38,281
6267,7,0,0,126,106,1,38,278
6268,7,0,0,126,106,1,38,278
6269,7,0,0,124,105,1,39,276
6270,7,1,0,123,107,38,38,314
6271,7,0,0,122,106,37,38,310
6272,7,2,0,122,105,37,38,311
6273,7,0,0,1,106,37,39,190
6274,7,0,0,0,106,37,38,188
6275,7,0,0,0,106,38,39,190
6276,7,0,0,0,106,37,39,189
6277,7,1,0,0,106,36,38,188
6278,7,0,0,1,108,36,38,190
6279,7,0,0,0,106,37,39,189
6280,7,0,0,0,107,37,39,190
6281,7,1,0,0,106,37,39,190
6282,7,0,0,0,107,37,39,190
6283,7,0,0,1,107,37,38,190
6284,7,0,0,0,107,37,39,190
6285,7,0,0,0,106,37,38,188
6286,7,0,0,0,105,37,38,187
6287,7,0,0,0,106,37,39,189
6288,7,1,0,0,106,38,38,190
6289,7,0,0,0,106,37,39,189
6290,7,0,0,0,106,36,39,188
6291,7,0,0,0,105,38,39,189
6292,7,0,0,0,106,38,38,189
6293,7,0,0,0,105,37,39,188
6294,7,2,0,0,106,37,38,190
6295,7,0,0,0,106,38,38,189
6296,7,0,0,0,106,36,38,187
6297,7,0,0,0,114,1505,39,1665
6298,7,0,0,0,114,1617,38,1776
6299,7,1,0,0,114,1688,38,1848
6300,7,0,0,10,114,1717,38,1886
6301,7,0,0,1,115,1721,39,1883
6302,7,0,0,0,114,1737,38,1896
6303,7,0,0,1,114,1747,39,1908
6304,7,0,0,0,115,1750,38,1910
6305,7,0,0,0,114,1758,39,1918
6306,7,1,0,149,115,1765,39,2076
6307,7,0,0,139,114,1763,39,2062
6308,7,1,0,128,113,1773,38,2060
6309,7,0,0,128,115,1769,39,2058
6310,7,0,0,127,115,1776,39,2064
6311,7,1,0,125,113,1777,39,2062
6312,7,0,0,126,114,1778,39,2064
6313,7,0,0,125,113,1784,39,2068
6314,7,0,0,122,114,1785,39,2067
6315,7,1,0,122,114,1791,39,2074
6316,7,0,0,0,113,1786,38,1944
6317,7,0,0,0,115,1781,38,1941
6318,7,0,0,0,114,1783,38,1942
6319,7,0,0,0,114,1786,39,1946
6320,7,0,0,1,114,1786,39,1947
6321,7,0,0,10,115,1783,39,1954
6322,7,0,0,7,114,1794,39,1961
6323,7,0,0,7,115,1797,39,1965
6324,7,0,0,7,114,1790,38,1956
6325,7,0,0,7,114,1795,38,1961
6326,7,1,0,7,114,1795,39,1963
6327,7,1,0,7,115,1800,39,1969
6328,7,0,0,7,115,1806,39,1974
6329,7,0,0,7,114,1786,38,1952
6330,7,0,0,7,114,1790,39,1957
6331,7,1,0,7,114,1802,38,1969
6332,7,0,0,157,115,1798,39,2116
6333,7,0,0,140,114,1800,39,2100
6334,7,0,0,136,113,1789,39,2084
6335,7,0,0,135,115,1806,38,2101
6336,7,0,0,135,114,1808,39,2103
6337,7,0,0,135,107,1,39,289
6338,7,1,0,133,107,1,38,287
6339,7,1,0,132,106,1,39,286
6340,7,0,0,131,107,0,39,284
6341,7,1,0,132,106,1,38,285
6342,7,0,0,130,107,1,39,284
6343,7,0,0,131,106,1,39,284
6344,7,0,0,130,107,1,39,284
6345,7,0,0,130,107,1,38,283
6346,7,0,0,129,106,1,39,282
6347,7,0,0,129,106,1,39,282
6348,7,0,0,129,107,1,39,283
6349,7,2,0,127,106,1,39,282
6350,7,1,0,125,107,1,38,279
6351,7,0,0,123,106,1,38,275
6352,7,0,0,0,105,1,39,152
6353,7,0,0,0,107,1,38,153
6354,7,0,0,0,106,41,38,192
6355,7,0,0,1,106,37,39,190
6356,7,1,0,1,106,38,39,192
6357,7,0,0,0,106,38,38,189
6358,7,0,0,0,105,38,39,189
6359,7,0,0,0,104,38,39,188
6360,7,0,0,1,105,37,38,188
6361,7,0,0,0,104,37,38,186
6362,7,1,0,0,107,38,38,191
6363,7,1,0,0,106,37,38,189
6364,7,0,0,0,106,37,39,189
6365,7,0,0,0,106,38,38,189
6366,7,0,0,0,106,38,39,190
6367,7,0,0,1,107,37,39,191
6368,7,0,0,0,107,37,38,189
6369,7,0,0,1,108,38,39,193
6370,7,0,0,0,106,38,39,190
6371,7,0,0,0,106,38,39,190
6372,7,1,0,0,106,37,39,190
6373,7,0,0,0,106,37,39,189
6374,7,1,0,0,106,37,38,189
6375,7,0,0,0,106,38,38,189
6376,7,0,0,0,106,38,39,190
6377,7,0,0,0,106,36,38,187
6378,7,0,0,0,106,38,39,190
6379,7,0,0,0,106,38,38,189
6380,7,1,0,0,106,37,38,189
6381,7,1,0,0,106,37,39,190
6382,7,0,0,140,106,36,38,327
6383,7,0,0,140,114,1376,38,1675
6384,7,0,0,128,114,1624,39,1912
6385,7,0,0,127,114,1703,39,1990
6386,7,0,0,126,115,1727,39,2014
6387,7,0,0,125,114,1746,39,2031
6388,7,0,0,125,115,1715,39,2001
6389,7,1,0,122,115,1735,38,2018
6390,7,1,0,123,114,1744,38,2027
6391,7,0,0,122,116,1750,38,2033
6392,7,0,0,0,115,1755,39,1916
6393,7,1,0,1,115,1765,38,1927
6394,7,0,0,0,115,1770,38,1930
6395,7,0,0,0,114,1771,38,1930
6396,7,0,0,0,115,1770,38,1930
6397,7,0,0,0,114,1773,38,1932
6398,7,0,0,0,114,1778,38,1937
6399,7,0,0,0,114,1774,38,1933
6400,7,0,0,0,114,1781,38,1940
6401,7,1,0,0,114,1778,39,1939
6402,7,1,0,0,114,1785,39,1946
6403,7,0,0,0,114,1785,39,1945
6404,7,0,0,0,114,1776,38,1935
6405,7,1,0,0,114,1784,38,1944
6406,7,0,0,0,114,1791,39,1951
6407,7,0,0,0,114,1792,39,1952
6408,7,1,0,0,114,1790,38,1950
6409,7,0,0,7,114,1789,38,1955
6410,7,0,0,0,115,1794,39,1955
6411,7,1,0,0,114,1792,38,1952
6412,7,0,0,0,114,1795,39,1955
6413,7,1,0,0,114,1795,38,1955
6414,7,1,0,0,115,1800,38,1961
6415,7,1,0,0,114,1801,38,1961
6416,7,0,0,0,113,1797,38,1955
6417,7,0,0,0,114,1798,38,1957
6418,7,0,0,0,114,1801,39,1961
6419,7,1,0,0,113,1803,38,1962
6420,7,0,0,0,114,1808,39,1968
6421,7,0,0,0,114,1805,38,1964
6422,7,0,0,0,114,1801,38,1960
6423,7,0,0,126,115,1801,39,2088
6424,7,1,0,141,114,1810,39,2112
6425,7,0,0,131,113,1809,38,2098
6426,7,0,0,127,106,1,38,279
6427,7,0,0,127,107,1,38,280
6428,7,1,0,125,106,1,39,279
6429,7,0,0,126,107,1,38,279
6430,7,1,0,124,107,1,38,278
6431,7,1,0,124,106,1,39,278
6432,7,0,0,122,106,1,39,275
6433,7,1,0,1,107,1,39,156
6434,7,0,0,0,106,1,38,152
6435,7,1,0,0,106,1,38,153
6436,7,1,0,0,106,1,38,153
6437,7,0,0,0,106,1,38,152
6438,7,0,0,1,106,1,38,153
6439,7,0,0,0,106,1,38,152
6440,7,1,0,0,105,0,39,152
6441,7,0,0,0,106,1,39,153
6442,7,0,0,0,106,41,38,192
6443,7,0,0,0,106,38,38,189
6444,7,0,0,0,106,38,39,190
6445,7,1,0,0,105,37,39,189
6446,7,1,0,0,106,37,38,189
6447,7,1,0,0,107,36,38,189
6448,7,0,0,0,106,37,39,189
6449,7,0,0,0,106,37,39,189
6450,7,1,0,0,105,37,39,189
6451,7,1,0,0,106,36,39,189
6452,7,0,0,0,105,36,38,186
6453,7,0,0,0,106,38,39,190
6454,7,0,0,0,106,37,38,188
6455,7,0,0,0,104,37,39,187
6456,7,0,0,1,105,37,39,189
6457,7,0,0,0,107,38,38,190
6458,7,0,0,0,106,37,39,189
6459,7,0,0,0,107,36,39,189
6460,7,0,0,1,106,38,39,191
6461,7,1,0,0,105,37,39,189
6462,7,0,0,0,106,37,38,188
6463,7,0,0,0,106,36,38,187
6464,7,1,0,0,106,38,39,191
6465,7,0,0,0,105,37,38,187
6466,7,0,0,0,106,36,39,188
6467,7,1,0,0,107,37,38,190
6468,7,1,0,0,105,36,38,187
6469,7,1,0,1,115,1466,39,1629
6470,7,0,0,151,114,1651,38,1961
6471,7,0,0,134,115,1712,39,2007
6472,7,1,0,129,115,1735,38,2025
6473,7,1,0,128,115,1754,38,2043
6474,7,0,0,125,114,1733,38,2017
6475,7,1,0,126,115,1741,39,2029
6476,7,0,0,124,115,1750,39,2035
6477,7,0,0,124,115,1759,39,2044
6478,7,0,0,123,115,1766,38,2049
6479,7,0,0,124,114,1770,39,2054
6480,7,0,0,121,113,1775,38,2054
6481,7,0,0,121,114,1778,39,2059
6482,7,0,0,120,115,1779,39,2060
6483,7,0,0,0,114,1783,39,1943
6484,7,0,0,0,114,1787,38,1946
6485,7,1,0,0,114,1789,38,1949
6486,7,0,0,0,114,1787,38,1946
6487,7,0,0,458,114,1791,38,2408
6488,7,1,0,451,114,1792,38,2403
6489,7,0,0,449,114,1792,39,2401
6490,7,1,0,445,115,1795,39,2402
6491,7,0,0,445,114,1798,38,2402
6492,7,0,0,444,115,1800,38,2404
6493,7,0,0,443,114,1799,39,2402
6494,7,0,0,444,114,1801,38,2404
6495,7,0,0,445,114,1800,39,2405
6496,8,1,0,445,114,1803,37,2408
6497,7,1,0,446,115,1805,38,2412
6498,7,1,0,444,114,1803,39,2408
6499,7,0,0,444,114,1805,38,2408
6500,7,0,0,1,114,1806,38,1966
6501,7,0,0,1,113,1809,38,1968
6502,7,1,0,1,114,1806,39,1968
6503,7,1,0,1,114,1810,38,1971
6504,8,0,0,214,114,1807,39,2182
6505,7,0,0,154,114,1808,38,2121
6506,7,0,0,154,113,1811,38,2123
6507,7,0,0,156,114,1811,39,2127
6508,7,0,0,155,113,1810,39,2124
6509,7,0,0,149,114,1810,39,2119
6510,7,0,0,146,115,1813,38,2119
6511,7,0,0,144,115,1818,38,2122
6512,7,1,0,143,113,1814,38,2116
6513,7,0,0,142,113,1816,39,2117
6514,7,0,0,140,114,1818,38,2117
6515,7,0,0,140,107,1,39,294
6516,7,1,0,138,108,1,38,293
6517,7,0,0,138,106,1,39,291
6518,7,1,0,137,106,1,39,291
6519,7,0,0,136,107,0,39,289
6520,7,1,0,135,106,1,39,289
6521,7,1,0,135,106,1,38,288
6522,7,1,0,135,105,1,38,287
6523,7,0,0,134,106,1,38,286
6524,7,0,0,133,106,1,38,285
6525,7,1,0,133,105,1,38,285
6526,7,0,0,133,106,0,39,285
6527,7,1,0,133,106,1,39,287
6528,7,0,0,132,106,0,38,283
6529,7,0,0,132,106,1,38,284
6530,7,0,0,132,107,0,38,284
6531,7,0,0,132,106,1,37,283
6532,7,0,0,131,106,37,38,319
6533,7,0,0,130,106,38,39,320
6534,7,1,0,131,106,37,38,320
6535,7,0,0,130,106,37,38,318
6536,7,0,0,130,105,38,38,318
6537,7,0,0,127,105,36,38,313
6538,7,0,0,125,106,37,38,313
6539,7,1,0,124,106,37,39,314
6540,7,1,0,123,106,37,38,312
6541,7,0,0,122,104,37,39,309
6542,7,0,0,0,106,37,39,189
6543,7,0,0,0,114,1533,38,1692
6544,7,0,0,0,115,1699,39,1860
6545,7,0,0,0,114,1751,39,1911
6546,7,1,0,0,114,1737,38,1897
6547,7,0,0,0,114,1751,38,1910
6548,7,0,0,0,114,1761,39,1921
6549,7,0,0,0,115,1770,38,1930
6550,7,1,0,0,115,1779,39,1941
6551,7,0,0,0,116,1784,39,1946
6552,7,0,0,0,115,1786,39,1947
6553,7,1,0,0,115,1791,39,1953
6554,7,0,0,0,115,1794,39,1955
6555,7,1,0,0,114,1795,39,1956
6556,7,1,0,0,116,1800,39,1963
6557,7,0,0,0,115,1800,38,1960
6558,7,1,0,0,115,1802,37,1962
6559,7,0,0,0,113,1800,38,1958
6560,7,1,0,0,115,1808,39,1970
6561,7,1,0,0,115,1803,38,1964
6562,7,1,0,0,114,1808,38,1968
6563,7,1,0,0,114,1807,38,1967
6564,7,0,0,0,115,1808,38,1968
6565,7,1,0,0,114,1810,39,1971
6566,7,0,0,0,114,1814,40,1975
6567,7,0,0,144,115,1813,38,2117
6568,7,1,0,132,114,1811,40,2105
6569,7,0,0,127,114,1813,39,2100
6570,7,0,0,126,114,1816,39,2102
6571,7,1,0,125,115,1813,38,2099
6572,7,1,0,125,107,173,39,452
6573,7,0,0,124,107,1,39,278
6574,7,0,0,123,107,1,39,277
6575,7,0,0,122,106,1,39,275
6576,7,1,0,122,107,0,39,276
6577,7,0,0,0,107,1,38,153
6578,7,0,0,0,106,1,39,153
6579,7,0,0,0,106,1,38,152
6580,7,0,0,0,106,1,39,153
6581,7,0,0,0,106,1,39,153
6582,7,1,0,0,107,1,38,154
6583,7,0,0,0,105,1,38,151
6584,7,0,0,0,106,1,38,152
6585,7,1,0,1,106,1,38,154
6586,7,0,0,0,106,1,39,153
6587,7,0,0,0,107,1,39,154
6588,7,0,0,0,106,1,38,152
6589,7,1,0,0,106,1,38,153
6590,7,0,0,0,106,0,38,151
6591,7,0,0,0,106,38,39,190
6592,7,0,0,0,106,37,38,188
6593,7,0,0,0,105,38,39,189
6594,7,0,0,1,106,37,39,190
6595,7,1,0,0,106,36,38,188
6596,7,0,0,1,105,38,39,190
6597,7,0,0,10,106,37,38,198
6598,7,0,0,0,105,37,38,187
6599,7,1,0,1,105,37,39,190
6600,7,0,0,0,105,37,38,187
6601,7,0,0,1,105,37,38,188
6602,7,0,0,0,106,37,39,189
6603,7,0,0,0,104,36,38,185
6604,7,1,0,143,105,36,38,330
6605,7,0,0,139,106,38,39,329
6606,7,1,0,127,105,37,38,315
6607,7,1,0,127,106,36,39,316
6608,7,0,0,125,114,1382,38,1666
6609,7,0,0,124,115,1637,38,1921
6610,7,0,0,123,114,1715,38,1997
6611,7,0,0,123,115,1739,39,2023
6612,7,0,0,122,113,1760,38,2040
6613,7,0,0,122,113,1735,38,2015
6614,7,2,0,0,114,1745,38,1906
6615,7,0,0,0,114,1755,38,1914
6616,7,0,0,0,114,1763,38,1922
6617,7,0,0,0,114,1768,38,1927
6618,7,0,0,0,114,1770,38,1929
6619,7,0,0,1,113,1777,38,1936
6620,7,0,0,0,113,1781,38,1939
6621,7,0,0,0,113,1782,38,1940
6622,7,1,0,0,113,1787,38,1946
6623,7,0,0,0,113,1790,38,1948
6624,7,0,0,0,113,1793,38,1951
6625,7,1,0,0,114,1795,38,1955
6626,7,0,0,0,113,1794,39,1953
6627,7,0,0,0,114,1800,38,1959
6628,7,0,0,0,113,1795,40,1955
6629,7,0,0,0,114,1800,39,1960
6630,7,0,0,0,113,1798,38,1956
6631,7,0,0,0,114,1799,38,1958
6632,7,0,0,0,114,1802,38,1961
6633,7,0,0,0,114,1802,38,1961
6634,7,0,0,0,113,1800,38,1958
6635,7,0,0,0,113,1803,38,1961
6636,7,0,0,0,112,1808,39,1966
6637,7,1,0,0,113,1807,38,1966
6638,7,0,0,0,113,1808,38,1966
6639,7,1,0,0,112,1808,38,1966
6640,7,1,0,0,112,1806,39,1965
6641,7,0,0,0,106,1,39,153
6642,7,1,0,0,106,0,38,152
6643,7,0,0,0,106,0,38,151
6644,7,0,0,0,107,1,39,154
6645,7,1,0,0,106,1,38,153
6646,7,1,0,0,106,1,38,153
6647,7,0,0,0,106,0,39,152
6648,7,0,0,144,106,0,39,296
6649,7,2,0,130,107,1,38,285
6650,7,0,0,127,105,0,38,277
6651,7,0,0,126,105,0,38,276
6652,7,0,0,126,106,1,38,278
6653,7,0,0,124,106,0,38,275
6654,7,0,0,124,106,0,38,275
6655,7,0,0,123,106,0,38,274
6656,7,0,0,126,106,4,38,281
6657,7,1,0,126,106,38,38,316
6658,7,0,0,7,106,38,39,197
6659,7,0,0,7,106,38,38,196
6660,7,1,0,7,105,36,38,194
6661,7,0,0,7,106,36,39,195
6662,7,1,0,7,106,36,38,195
6663,7,0,0,7,105,36,38,193
6664,7,1,0,7,105,37,39,196
6665,7,0,0,7,106,35,39,194
6666,7,0,0,7,104,37,39,194
6667,7,0,0,7,106,36,38,194
6668,7,1,0,135,105,36,37,321
6669,7,0,0,143,106,36,39,331
6670,7,0,0,137,106,36,39,325
6671,7,0,0,135,106,36,39,323
6672,7,0,0,134,104,36,39,320
6673,7,0,0,133,106,36,38,320
6674,7,0,0,132,105,36,38,318
6675,7,0,0,131,105,36,38,317
6676,7,0,0,131,105,38,38,319
6677,7,0,0,131,106,36,38,318
6678,7,0,0,131,103,37,39,317
6679,7,1,0,129,106,37,38,318
6680,7,0,0,129,106,37,38,317
6681,7,1,0,129,105,36,39,317
6682,7,0,0,128,114,1281,38,1568
6683,7,0,0,129,114,1600,38,1888
6684,7,1,0,127,113,1704,38,1990
6685,7,0,0,126,115,1736,38,2022
6686,7,1,0,123,114,1755,39,2039
6687,7,0,0,122,114,1738,38,2019
6688,7,0,0,0,114,1737,38,1896
6689,7,0,0,0,114,1751,39,1911
6690,7,0,0,0,114,1761,38,1920
6691,7,0,0,0,114,1766,39,1926
6692,7,0,0,0,113,1767,39,1926
6693,7,0,0,0,114,1777,39,1937
6694,7,0,0,0,113,1776,39,1935
6695,7,1,0,0,113,1784,39,1944
6696,7,0,0,0,114,1785,38,1944
6697,7,1,0,0,114,1791,39,1952
6698,7,1,0,0,114,1792,38,1952
6699,7,0,0,0,114,1794,38,1953
6700,7,0,0,0,113,1800,39,1959
6701,7,0,0,0,114,1793,39,1953
6702,7,0,0,0,114,1802,38,1961
6703,7,1,0,0,113,1801,38,1960
6704,7,0,0,0,113,1809,39,1968
6705,7,0,0,0,113,1810,39,1969
6706,7,0,0,0,114,1811,39,1971
6707,7,0,0,0,106,0,39,152
6708,7,0,0,0,108,1,38,154
6709,7,0,0,0,106,1,38,152
6710,7,0,0,0,107,1,39,154
6711,7,0,0,0,108,0,38,153
6712,7,1,0,0,106,1,39,154
6713,7,1,0,0,107,1,38,154
6714,7,0,0,0,106,1,38,152
6715,7,0,0,0,106,1,38,152
6716,7,0,0,1168,106,1,39,1321
6717,7,0,0,141,106,1,39,294
6718,7,0,0,128,106,1,38,280
6719,7,0,0,126,106,1,38,278
6720,7,0,0,125,106,1,39,278
6721,7,1,0,124,106,1,38,277
6722,7,1,0,124,105,1,38,276
6723,6,0,0,122,105,0,38,271
6724,7,1,0,123,106,1,39,277
6725,7,0,0,121,106,39,39,312
6726,7,1,0,44,106,37,39,234
6727,7,1,0,0,105,37,38,188
6728,7,1,0,0,106,37,38,189
6729,7,0,0,0,106,38,39,190
6730,7,0,0,0,104,36,39,186
6731,7,0,0,1,106,38,39,191
6732,7,1,0,0,106,37,38,189
6733,7,0,0,0,106,38,39,190
6734,7,0,0,0,105,38,38,188
6735,7,0,0,0,105,37,39,188
6736,7,0,0,0,106,37,39,189
6737,7,0,0,0,105,37,38,187
6738,7,0,0,0,105,37,38,187
6739,7,1,0,0,104,37,39,188
6740,7,0,0,0,104,36,39,186
6741,7,0,0,0,104,36,61,208
6742,7,1,0,1,106,36,38,189
6743,7,1,0,1,105,36,37,187
6744,7,1,0,1,105,36,38,188
6745,7,0,0,10,106,36,38,197
6746,7,1,0,2,106,36,38,190
6747,7,0,0,0,104,37,38,186
6748,7,1,0,0,104,36,38,186
6749,7,1,0,0,106,38,39,191
6750,7,1,0,0,106,36,39,189
6751,7,0,0,0,106,36,38,187
6752,7,1,0,0,107,36,38,189
6753,7,0,0,0,106,38,39,190
6754,7,0,0,0,106,38,38,189
6755,7,0,0,148,107,36,38,336
6756,7,1,0,131,106,36,38,319
6757,7,1,0,127,107,37,38,317
6758,7,0,0,127,107,37,38,316
6759,7,0,0,126,105,36,38,312
6760,7,0,0,125,105,38,38,313
6761,7,0,0,123,106,37,38,311
6762,7,1,0,122,106,37,39,312
6763,7,0,0,123,104,36,39,309
6764,7,0,0,121,106,36,39,309
6765,7,0,0,0,106,36,38,187
6766,7,0,0,1,106,38,39,191
6767,7,0,0,0,105,36,39,187
6768,7,0,0,0,105,37,38,187
6769,7,0,0,0,106,37,38,188
6770,7,0,0,0,106,37,38,188
6771,7,0,0,1,106,36,38,188
6772,7,0,0,0,106,37,39,189
6773,7,0,0,0,105,37,38,187
6774,7,1,0,0,106,37,39,190
6775,7,0,0,0,105,37,39,188
6776,7,0,0,10,113,1021,38,1189
6777,7,1,0,7,114,1588,39,1756
6778,7,0,0,7,114,1704,38,1870
6779,7,0,0,7,114,1739,38,1905
6780,7,0,0,7,114,1755,39,1922
6781,7,0,0,7,115,1742,38,1909
6782,7,1,0,7,113,1735,38,1901
6783,7,0,0,7,115,1758,39,1926
6784,7,0,0,150,113,1760,38,2068
6785,7,0,0,139,114,1777,38,2075
6786,7,0,0,136,113,1765,39,2060
6787,7,0,0,134,114,1785,39,2079
6788,7,0,0,133,113,1784,38,2075
6789,7,0,0,134,114,1786,38,2079
6790,7,0,0,133,114,1794,39,2087
6791,7,1,0,132,114,1801,39,2094
6792,7,1,0,131,113,1808,38,2098
6793,7,0,0,131,113,1803,39,2093
6794,7,0,0,130,113,1824,38,2112
6795,7,0,0,130,113,1818,38,2106
6796,7,0,0,129,114,1813,38,2101
6797,7,0,0,129,107,0,38,281
6798,7,1,0,130,107,1,38,284
6799,7,0,0,130,108,1,38,284
6800,7,0,0,129,107,1,39,283
6801,7,0,0,127,106,1,38,279
6802,7,0,0,127,106,1,39,280
6803,7,0,0,129,105,1,39,281
6804,7,0,0,0,106,1,39,153
6805,7,0,0,1,106,1,38,153
6806,7,1,0,0,106,1,38,153
6807,7,1,0,0,106,1,39,154
6808,7,0,0,0,106,1,39,153
6809,7,0,0,0,106,1,38,152
6810,7,1,0,0,107,1,39,155
6811,7,1,0,0,106,1,39,154
6812,7,0,0,0,106,1,38,152
6813,7,0,0,0,107,39,39,192
6814,7,0,0,1,106,38,38,190
6815,7,1,0,0,106,37,38,189
6816,7,0,0,1,106,37,38,189
6817,7,1,0,1,106,37,38,190
6818,7,0,0,0,106,36,39,188
6819,7,0,0,0,106,37,38,188
6820,7,0,0,0,104,36,38,185
6821,7,0,0,1,106,37,38,189
6822,7,0,0,0,106,36,38,187
6823,7,0,0,1,106,37,38,189
6824,7,0,0,0,104,36,39,186
6825,7,1,0,0,104,36,38,186
6826,7,1,0,0,105,36,38,187
6827,7,1,0,0,106,36,39,189
6828,7,0,0,144,104,36,38,329
6829,7,0,0,130,105,37,38,317
6830,7,1,0,127,106,35,39,315
6831,7,0,0,127,106,37,39,316
6832,7,0,0,124,106,36,38,311
6833,333,0,0,124,106,36,39,638
6834,331,0,0,122,106,37,215,811
6835,331,0,0,121,103,36,181,772
6836,334,0,0,121,106,37,193,791
6837,332,0,0,0,107,36,213,688
6838,333,0,0,0,106,38,229,706
6839,333,0,0,0,106,36,195,670
6840,334,0,0,0,106,36,233,709
6841,330,1,0,0,114,1385,236,2066
6842,329,0,0,0,114,1622,249,2314
6843,327,0,0,0,115,1720,255,2417
6844,328,1,0,0,113,1753,250,2445
6845,328,1,0,0,114,1763,265,2471
6846,328,0,0,0,113,1737,259,2437
6847,327,0,0,0,113,1741,253,2434
6848,332,0,0,0,113,1761,259,2465
6849,332,0,0,0,114,1767,252,2465
6850,332,0,0,0,114,1762,259,2467
6851,333,0,0,0,114,1775,236,2458
6852,333,0,0,0,114,1786,263,2496
6853,332,0,0,0,114,1793,272,2511
6854,332,1,0,0,113,1789,273,2508
6855,332,0,0,0,113,1785,333,2563
6856,332,0,0,0,114,1801,260,2507
6857,333,1,0,0,114,1803,249,2500
6858,332,0,0,0,113,1798,275,2518
6859,331,0,0,0,114,1806,257,2508
6860,332,0,0,0,114,1799,295,2540
6861,333,0,0,0,108,1,265,707
6862,334,0,0,0,106,0,262,702
6863,331,1,0,10,106,1,284,733
6864,331,0,0,10,106,0,313,760
6865,332,1,0,0,106,0,236,675
6866,331,0,0,0,106,0,292,729
6867,330,1,0,0,106,0,292,729
6868,333,0,0,145,106,1,263,848
6869,333,0,0,138,106,1,246,824
6870,331,0,0,127,107,1,239,805
6871,332,1,0,126,105,1,278,843
6872,333,0,0,125,105,0,252,815
6873,333,0,0,125,107,1,250,816
6874,333,0,0,124,106,1,301,865
6875,333,0,0,122,106,1,252,814
6876,333,0,0,122,107,1,200,763
6877,333,0,0,121,106,1,258,819
6878,334,0,0,0,106,38,255,733
6879,333,0,0,0,106,38,419,896
6880,333,0,0,0,106,36,323,798
6881,333,0,0,0,104,37,271,745
6882,332,1,0,0,105,37,192,667
6883,329,0,0,0,106,38,228,701
6884,330,0,0,0,105,36,274,745
6885,331,0,0,0,106,37,258,732
6886,329,0,0,0,106,36,293,764
6887,330,0,0,0,106,36,259,731
6888,332,0,0,0,105,36,198,671
6889,332,0,0,0,105,36,279,752
6890,333,0,0,0,106,37,194,670
6891,333,0,0,0,106,37,259,735
6892,331,2,0,0,106,37,269,745
6893,331,1,0,0,106,37,246,721
6894,333,0,0,0,106,36,254,729
6895,331,1,0,0,104,38,240,714
6896,334,0,0,0,106,37,264,741
6897,334,1,0,0,106,37,241,719
6898,332,0,0,0,106,36,247,721
6899,335,0,0,0,107,35,314,791
6900,335,0,0,0,107,36,271,749
6901,334,0,0,0,107,37,270,748
6902,336,0,0,0,106,37,274,753
6903,333,1,0,0,106,37,264,741
6904,335,0,0,0,106,37,245,723
6905,336,0,0,0,106,37,246,725
6906,335,0,0,0,108,38,251,732
6907,334,0,0,0,106,36,262,738
6908,334,1,0,0,107,36,220,698
6909,336,0,0,0,106,37,263,742
6910,337,1,0,0,106,38,229,711
6911,7,0,0,1,107,37,49,201
6912,7,1,0,0,106,37,49,200
6913,7,0,0,142,104,35,49,337
6914,7,0,0,138,107,37,49,338
6915,7,0,0,129,106,37,49,328
6916,7,0,0,127,106,36,49,325
6917,7,0,0,127,106,37,49,326
6918,7,0,0,124,107,36,49,323
6919,7,1,0,126,105,37,50,326
6920,7,0,0,123,106,37,49,322
6921,7,0,0,122,107,36,49,321
6922,7,0,0,122,106,37,50,322
6923,7,0,0,0,106,36,49,198
6924,7,0,0,10,106,36,49,208
6925,7,1,0,7,106,36,48,205
6926,7,0,0,0,106,38,49,200
6927,7,1,0,0,106,36,49,199
6928,7,1,0,0,106,36,49,199
6929,7,0,0,0,105,36,49,197
6930,7,0,0,0,106,37,49,199
6931,7,0,0,0,106,36,50,199
6932,7,1,0,0,106,35,49,198
6933,7,1,0,0,106,37,49,200
6934,7,0,0,0,106,36,49,198
6935,7,0,0,0,106,36,49,198
6936,7,0,0,7,105,38,50,207
6937,7,1,0,7,106,37,49,207
6938,7,0,0,7,106,37,49,206
6939,7,0,0,7,106,37,49,206
6940,7,0,0,7,106,37,49,206
6941,7,0,0,7,106,37,49,206
6942,7,0,0,152,106,36,49,350
6943,7,1,0,140,106,35,49,338
6944,7,0,0,135,105,37,38,322
6945,7,1,0,136,106,36,38,324
6946,7,0,0,133,105,36,39,320
6947,7,0,0,133,106,36,38,320
6948,7,0,0,132,106,36,38,319
6949,7,0,0,132,104,37,39,319
6950,7,1,0,132,106,36,39,321
6951,7,0,0,132,106,37,38,320
6952,7,0,0,132,106,36,38,319
6953,7,0,0,131,106,36,38,318
6954,7,0,0,130,106,37,38,318
6955,7,0,0,130,104,37,38,316
6956,7,1,0,129,106,36,39,318
6957,7,0,0,128,106,37,38,316
6958,7,1,0,128,106,37,38,317
6959,7,0,0,128,105,37,38,315
6960,7,0,0,127,105,37,39,315
6961,7,0,0,127,106,36,39,315
6962,7,0,0,127,106,37,39,316
6963,7,0,0,127,106,36,38,314
6964,7,0,0,7,105,36,39,194
6965,7,0,0,7,105,36,39,194
6966,7,1,0,7,106,37,38,196
6967,7,0,0,0,104,36,38,185
6968,7,0,0,0,106,36,38,187
6969,7,1,0,0,105,37,38,188
6970,7,0,0,0,106,36,38,187
6971,7,0,0,0,104,37,38,186
6972,7,0,0,0,106,36,38,187
6973,7,0,0,0,106,36,39,188
6974,7,0,0,0,106,37,38,188
6975,7,1,0,0,107,37,39,191
6976,7,0,0,1,106,38,39,191
6977,7,0,0,150,107,37,38,339
6978,7,0,0,133,106,37,39,322
6979,7,0,0,126,106,36,39,314
6980,7,0,0,126,106,36,39,314
6981,7,0,0,125,106,37,39,314
6982,7,0,0,124,104,38,39,312
6983,7,0,0,123,106,36,38,310
6984,7,1,0,122,106,37,39,312
6985,7,0,0,121,106,36,38,308
6986,7,0,0,120,106,37,39,309
6987,7,0,0,0,106,36,39,188
6988,7,1,0,0,106,36,39,189
6989,7,0,0,0,105,36,40,188
6990,7,1,0,1,106,36,39,190
6991,7,0,0,0,106,36,39,188
6992,7,0,0,0,107,37,38,189
6993,7,0,0,0,107,38,39,191
6994,7,0,0,1,105,38,39,190
6995,7,0,0,0,107,36,38,188
6996,7,0,0,0,105,36,39,187
6997,7,0,0,1,106,36,39,189
6998,7,1,0,0,106,37,39,190
6999,7,0,0,0,106,36,39,188
7000,7,2,0,0,105,36,38,188
7001,7,1,0,0,107,37,39,191
7002,7,0,0,0,106,37,39,189
7003,7,0,0,0,107,37,38,189
7004,7,0,0,1,106,36,39,189
7005,7,0,0,0,104,35,39,185
7006,7,0,0,0,106,36,38,187
7007,7,0,0,0,104,37,39,187
7008,7,0,0,0,106,36,38,187
7009,7,0,0,0,104,36,38,185
7010,7,0,0,0,105,37,38,187
7011,7,0,0,0,106,36,39,188
7012,7,1,0,0,104,37,40,189
7013,7,1,0,1,106,36,38,189
7014,7,0,0,0,106,36,39,188
7015,7,0,0,0,106,36,38,187
7016,7,0,0,1,106,36,39,189
7017,7,0,0,1,106,36,38,188
7018,7,0,0,0,106,37,38,188
7019,7,0,0,0,106,37,39,189
7020,7,0,0,0,106,37,38,188
7021,7,0,0,146,105,37,39,334
7022,7,1,0,132,104,37,38,319
7023,7,1,0,126,105,36,38,313
7024,7,0,0,126,106,38,38,315
7025,7,0,0,125,104,36,39,311
7026,7,0,0,128,104,37,38,314
7027,7,0,0,126,106,36,38,313
7028,7,1,0,123,104,36,38,309
7029,7,0,0,122,105,36,39,309
7030,7,0,0,121,106,36,38,308
7031,7,0,0,1,105,38,39,190
7032,7,1,0,0,106,36,38,188
7033,7,0,0,0,104,36,38,185
7034,7,0,0,1,105,37,38,188
7035,7,0,0,0,114,1497,39,1657
7036,7,0,0,0,114,1642,40,1803
7037,7,0,0,0,114,1687,39,1847
7038,7,0,0,0,114,1722,39,1882
7039,7,0,0,0,114,1741,38,1900
7040,7,0,0,0,114,1745,39,1905
7041,7,0,0,0,114,1768,39,1928
7042,7,0,0,0,114,1773,39,1933
7043,7,0,0,0,114,1782,38,1941
7044,7,1,0,0,114,1786,38,1946
7045,7,1,0,1,114,1785,39,1947
7046,7,0,0,0,115,1795,39,1956
7047,7,0,0,0,113,1798,38,1956
7048,7,0,0,0,114,1800,39,1960
7049,7,0,0,0,113,1799,38,1957
7050,7,0,0,0,114,1794,39,1954
7051,7,0,0,0,114,1816,38,1975
7052,7,1,0,0,114,1807,39,1968
7053,7,0,0,0,114,1800,39,1960
7054,7,1,0,0,115,1822,39,1984
7055,7,0,0,7,114,1814,39,1981
7056,7,0,0,7,114,1811,38,1977
7057,7,0,0,7,114,1827,38,1993
7058,7,1,0,7,114,1823,39,1991
7059,7,0,0,156,108,1,39,311
7060,7,1,0,140,108,1,38,295
7061,7,0,0,138,107,1,38,291
7062,7,0,0,135,108,1,39,290
7063,7,0,0,134,108,1,38,288
7064,7,0,0,135,106,1,39,288
7065,7,0,0,134,107,1,38,287
7066,7,0,0,133,106,1,38,285
7067,7,1,0,132,106,1,39,286
7068,7,0,0,132,106,1,38,284
7069,7,0,0,131,106,1,39,284
7070,7,1,0,131,106,1,39,285
7071,7,0,0,131,106,1,39,284
7072,7,0,0,130,107,1,39,284
7073,7,1,0,129,108,0,38,283
7074,7,0,0,130,107,1,38,283
7075,7,1,0,0,106,1,38,153
7076,7,0,0,10,106,41,40,204
7077,7,0,0,7,107,37,39,197
7078,7,0,0,7,106,38,38,196
7079,7,0,0,7,106,38,39,197
7080,7,0,0,6,104,37,38,192
7081,7,0,0,7,106,38,39,197
7082,7,0,0,6,106,37,39,195
7083,7,0,0,5,107,37,39,195
7084,7,0,0,140,106,36,39,328
7085,7,0,0,131,106,37,38,319
7086,7,0,0,140,108,37,38,330
7087,7,0,0,131,107,36,38,319
7088,7,0,0,128,106,38,39,318
7089,7,1,0,127,106,37,38,316
7090,7,0,0,140,107,37,38,329
7091,7,1,0,131,106,37,38,320
7092,7,0,0,128,107,38,38,318
7093,7,0,0,127,106,37,38,315
7094,7,0,0,125,105,36,38,311
7095,7,0,0,123,107,37,38,312
7096,7,1,0,123,106,36,39,312
7097,7,0,0,122,106,38,39,312
7098,7,0,0,121,107,37,39,311
7099,7,0,0,0,106,36,39,188
7100,7,0,0,0,106,37,38,188
7101,7,0,0,0,106,37,39,189
7102,7,1,0,0,106,36,38,188
7103,7,0,0,0,106,36,39,188
7104,7,0,0,0,106,38,38,189
7105,7,1,0,0,106,36,38,188
7106,7,1,0,0,107,36,39,190
7107,7,0,0,0,106,37,39,189
7108,7,0,0,0,105,37,39,188
7109,7,0,0,0,106,37,39,189
7110,7,0,0,0,106,36,39,188
7111,7,0,0,0,107,37,39,190
7112,7,0,0,0,106,37,39,189
7113,7,0,0,0,106,37,38,188
7114,7,1,0,0,107,38,38,191
7115,7,0,0,0,106,38,38,189
7116,7,0,0,0,106,38,39,190
7117,7,0,0,0,106,36,38,187
7118,7,0,0,0,106,38,39,190
7119,7,0,0,0,106,37,39,189
7120,7,0,0,0,107,36,39,189
7121,7,1,0,0,106,37,39,190
7122,7,0,0,0,106,38,38,189
7123,7,0,0,0,107,36,39,189
7124,7,1,0,0,106,37,39,190
7125,7,1,0,0,106,37,39,190
7126,7,1,0,0,106,37,39,190
7127,7,1,0,0,106,36,39,189
7128,7,0,0,0,106,36,40,189
7129,7,1,0,0,106,36,39,189
7130,7,0,0,0,106,37,39,189
7131,7,0,0,0,106,36,39,188
7132,7,0,0,0,106,37,39,189
7133,7,0,0,0,106,37,39,189
7134,7,0,0,0,106,37,39,189
7135,7,0,0,124,107,37,39,314
7136,7,1,0,123,106,37,39,313
7137,7,1,0,123,106,37,39,313
7138,7,0,0,127,106,36,39,315
7139,7,1,0,123,106,37,39,313
7140,7,1,0,124,106,37,39,314
7141,7,0,0,123,106,36,39,311
7142,7,0,0,123,106,36,39,311
7143,7,1,0,127,106,38,39,318
7144,7,0,0,123,106,36,38,310
7145,7,1,0,0,107,37,39,191
7146,7,0,0,0,106,38,38,189
7147,7,0,0,0,106,37,38,188
7148,7,0,0,0,106,37,39,189
7149,7,0,0,1,105,38,38,189
7150,7,0,0,1,106,36,39,189
7151,7,0,0,0,105,37,39,188
7152,7,0,0,0,106,38,39,190
7153,7,0,0,0,106,36,38,187
7154,7,0,0,0,105,37,38,187
7155,7,0,0,0,106,38,38,189
7156,7,0,0,0,107,37,39,190
7157,7,0,0,0,106,37,39,189
7158,7,1,0,1,105,38,38,190
7159,7,0,0,1,106,38,39,191
7160,7,0,0,0,106,37,38,188
7161,7,1,0,0,107,37,38,190
7162,7,0,0,0,105,36,39,187
7163,7,0,0,0,106,36,39,188
7164,7,0,0,0,106,35,38,186
7165,7,0,0,0,106,36,38,187
7166,7,1,0,0,106,38,39,191
7167,7,0,0,0,115,1418,39,1579
7168,7,0,0,0,115,1626,38,1786
7169,7,1,0,0,115,1726,39,1888
7170,7,0,0,0,114,1728,39,1888
7171,7,0,0,0,115,1752,39,1913
7172,7,0,0,0,113,1766,38,1924
7173,7,0,0,0,113,1784,39,1943
7174,7,1,0,0,114,1773,38,1933
7175,7,0,0,0,114,1791,38,1950
7176,7,0,0,81,113,1793,39,2033
7177,7,0,0,0,114,1801,39,1961
7178,7,0,0,149,115,1810,39,2120
7179,7,0,0,136,114,1803,39,2099
7180,7,0,0,127,114,1813,38,2099
7181,7,1,0,126,113,1814,39,2100
7182,7,0,0,128,114,1818,38,2105
7183,7,0,0,130,113,1824,38,2112
7184,7,0,0,131,113,1821,39,2111
7185,7,0,0,131,113,1824,38,2113
7186,7,0,0,131,107,1,38,284
7187,7,0,0,131,108,1,39,286
7188,7,0,0,131,107,1,38,284
7189,7,0,0,129,106,1,38,281
7190,7,1,0,129,106,1,39,283
7191,7,0,0,128,106,1,38,280
7192,7,0,0,127,107,1,38,280
7193,7,0,0,127,108,0,38,280
7194,7,0,0,127,106,1,38,279
7195,7,1,0,7,106,1,38,160
7196,7,1,0,7,106,1,38,160
7197,7,0,0,7,107,1,39,161
7198,7,0,0,7,106,1,39,160
7199,7,0,0,7,106,0,38,158
7200,7,0,0,7,106,1,39,160
7201,7,0,0,7,106,1,38,159
7202,7,0,0,7,106,1,39,160
7203,7,0,0,232,106,39,38,422
7204,7,1,0,138,106,38,38,328
7205,7,1,0,138,107,37,39,329
7206,7,0,0,136,106,37,39,325
7207,7,0,0,135,106,36,38,322
7208,7,0,0,134,105,37,38,321
7209,7,0,0,133,106,38,39,323
7210,7,1,0,134,106,38,38,324
7211,7,1,0,132,107,36,38,321
7212,7,0,0,132,106,36,38,319
7213,7,0,0,131,106,36,39,319
7214,7,1,0,131,107,37,38,321
7215,7,0,0,130,106,36,39,318
7216,7,0,0,130,107,37,39,320
7217,7,0,0,129,107,37,39,319
7218,7,1,0,129,106,36,39,318
7219,7,1,0,129,106,35,38,316
7220,7,0,0,128,107,37,38,317
7221,7,0,0,128,107,37,39,318
7222,7,0,0,129,106,36,38,316
7223,7,1,0,130,107,37,39,321
7224,7,0,0,124,107,36,38,312
7225,7,0,0,1,107,37,39,191
7226,7,1,0,0,107,37,39,191
7227,7,0,0,0,107,36,39,189
7228,7,0,0,0,106,36,39,188
7229,7,0,0,0,107,37,38,189
7230,7,0,0,1,107,36,38,189
7231,7,0,0,0,106,38,38,189
7232,7,0,0,1,107,36,38,189
7233,7,0,0,0,106,37,38,188
7234,7,0,0,0,108,36,39,190
7235,7,1,0,0,107,37,38,190
7236,7,0,0,0,106,36,38,187
7237,7,0,0,0,106,36,38,187
7238,7,0,0,0,107,37,39,190
7239,7,0,0,0,106,37,38,188
7240,7,1,0,1,107,36,39,191
7241,7,0,0,0,107,36,39,189
7242,7,0,0,0,106,37,38,188
7243,7,0,0,0,106,36,38,187
7244,7,1,0,0,106,36,38,188
7245,7,1,0,0,107,37,39,191
7246,7,0,0,0,107,35,39,188
7247,7,0,0,0,107,37,38,189
7248,7,0,0,0,108,37,39,191
7249,7,0,0,0,108,36,39,190
7250,7,1,0,140,106,36,39,329
7251,7,0,0,139,107,36,39,328
7252,7,0,0,129,108,36,38,318
7253,7,0,0,127,107,37,38,316
7254,7,0,0,127,106,37,39,316
7255,7,0,0,127,107,36,38,315
7256,7,0,0,125,107,38,39,316
7257,7,0,0,123,107,37,38,312
7258,7,0,0,123,107,36,38,311
7259,7,1,0,122,107,37,38,312
7260,7,0,0,0,106,37,38,188
7261,7,0,0,0,107,37,39,190
7262,7,0,0,0,106,37,39,189
7263,7,0,0,0,106,37,38,188
7264,7,0,0,1,107,36,39,190
7265,7,0,0,0,107,36,39,189
7266,7,0,0,0,106,37,39,189
7267,7,0,0,0,107,36,39,189
7268,7,1,0,0,106,37,39,190
7269,7,1,0,0,107,36,38,189
7270,7,0,0,0,108,38,39,192
7271,7,0,0,0,107,37,38,189
7272,7,1,0,0,106,37,38,189
7273,7,0,0,0,107,37,38,189
7274,7,1,0,0,106,37,38,189
7275,7,0,0,0,106,37,39,189
7276,7,0,0,0,107,36,39,189
7277,7,0,0,0,106,36,38,187
7278,7,0,0,0,107,36,38,188
7279,7,0,0,0,106,37,38,188
7280,7,0,0,1,107,37,39,191
7281,7,0,0,0,106,37,38,188
7282,7,1,0,0,106,37,38,189
7283,7,1,0,10,108,37,39,202
7284,7,1,0,7,106,37,39,197
7285,7,1,0,0,106,37,39,190
7286,7,0,0,0,106,36,39,188
7287,7,2,0,0,107,37,38,191
7288,7,0,0,1,106,37,39,190
7289,7,0,0,147,107,38,38,337
7290,7,0,14,135,106,37,38,337
7291,7,0,14,128,106,37,38,330
7292,7,0,7,127,107,38,38,324
7293,7,0,142,126,106,36,39,456
7294,7,0,760,124,107,36,37,1071
7295,8,0,761,123,106,35,38,1071
7296,7,0,759,122,106,36,38,1068
7297,7,0,753,122,106,36,38,1062
7298,7,0,14,122,106,36,39,324
7299,7,1,14,0,106,37,38,203
7300,7,0,7,1,106,35,38,194
7301,7,0,3,0,106,37,39,192
7302,7,0,774,0,106,36,39,962
7303,7,0,774,0,107,37,38,963
7304,7,0,767,0,106,36,38,954
7305,7,0,769,0,106,35,38,955
7306,7,0,13,0,106,36,39,201
7307,7,0,14,1,106,36,39,203
7308,7,1,7,0,106,36,39,196
7309,7,0,134,0,106,35,38,320
7310,7,0,762,9,106,36,38,958
7311,7,0,774,6,107,36,37,967
7312,7,0,762,6,106,36,38,955
7313,8,0,764,6,107,36,38,959
7314,7,1,14,7,106,36,38,209
7315,7,0,13,7,106,36,39,208
7316,7,1,6,7,106,36,39,202
7317,7,0,3,7,106,36,38,197
7318,7,1,137,152,106,38,38,479
7319,7,1,136,219,106,36,38,543
7320,7,0,138,136,106,36,38,461
7321,7,0,142,136,108,37,38,468
7322,7,1,14,136,106,36,39,339
7323,7,0,14,136,106,38,39,340
7324,7,0,7,135,107,37,38,331
7325,7,0,3,133,106,36,38,323
7326,7,0,143,133,106,36,38,463
7327,7,0,138,132,106,37,38,458
7328,7,0,137,131,106,36,38,455
7329,7,0,138,130,107,35,38,455
7330,7,0,14,131,106,37,38,333
7331,7,0,14,130,107,36,38,332
7332,7,0,7,129,106,36,38,323
7333,7,1,3,128,108,37,38,322
7334,7,1,149,128,106,37,39,467
7335,7,0,127,128,106,36,38,442
7336,7,0,754,127,106,36,39,1069
7337,7,0,763,127,106,36,38,1077
7338,7,0,765,127,106,36,38,1079
7339,8,0,771,127,107,37,38,1088
7340,7,0,770,6,106,37,38,964
7341,7,0,773,6,106,36,38,966
7342,8,0,768,6,107,36,38,963
7343,7,0,762,6,106,36,38,955
7344,7,1,767,0,107,37,38,957
7345,7,0,772,0,106,37,38,960
7346,7,0,769,0,107,36,38,957
7347,8,0,770,0,107,36,38,959
7348,8,0,765,0,106,36,38,953
7349,8,0,771,0,106,36,38,959
7350,7,0,778,0,108,36,38,967
7351,7,0,770,38,106,36,38,995
7352,7,0,764,140,107,36,38,1092
7353,7,0,760,127,106,36,38,1074
7354,7,0,764,126,106,36,38,1077
7355,7,0,764,125,106,35,38,1075
7356,7,0,758,123,107,35,38,1068
7357,8,0,766,122,106,37,38,1077
7358,8,1,764,123,108,36,38,1078
7359,7,0,769,122,107,36,38,1079
7360,7,0,776,120,106,36,38,1083
7361,8,0,777,0,107,36,38,966
7362,8,0,771,0,107,38,38,962
7363,8,0,772,0,107,36,38,961
7364,7,0,13,0,106,36,38,200
7365,7,0,14,0,107,37,38,203
7366,7,0,7,0,106,37,39,196
7367,7,1,7,0,107,37,38,197
7368,7,1,140,0,106,37,39,330
7369,7,0,134,0,106,36,39,322
7370,7,0,134,0,106,37,39,323
7371,7,0,132,0,106,36,39,320
7372,7,1,13,0,106,36,39,202
7373,7,0,14,0,105,36,38,200
7374,7,0,7,1,106,37,39,197
7375,7,1,6,0,106,36,39,195
7376,7,1,154,0,106,36,38,342
7377,7,1,149,0,106,36,39,338
7378,8,0,772,0,106,36,39,961
7379,8,0,768,0,106,36,38,956
7380,7,1,763,0,107,37,38,953
7381,7,0,762,0,106,36,39,950
7382,7,0,764,0,106,35,39,951
7383,8,1,762,0,106,36,38,951
7384,8,0,759,0,106,37,38,948
7385,8,0,759,0,106,36,38,947
7386,7,0,758,0,106,36,37,944
7387,8,0,757,0,106,35,38,944
7388,8,0,758,0,106,35,38,945
7389,7,0,759,0,106,36,39,947
7390,7,0,758,0,106,37,37,945
7391,8,1,760,0,106,36,39,950
7392,8,0,743,0,106,36,38,931
7393,8,1,741,0,106,35,38,929
7394,7,0,18,0,106,36,38,205
7395,7,0,14,140,106,36,38,341
7396,7,1,3,128,106,36,39,320
7397,7,1,3,127,106,37,38,319
7398,7,0,2,125,107,36,39,316
7399,7,0,3,124,107,37,38,316
7400,7,2,2,123,106,36,39,315
7401,7,0,3,123,106,35,38,312
7402,7,0,3,122,107,37,38,314
7403,7,1,2,125,106,36,39,316
7404,327,0,2,122,106,36,38,631
7405,327,1,2,0,106,36,200,672
7406,329,0,3,0,106,35,218,691
7407,329,0,2,0,106,36,193,666
7408,329,0,2,0,107,35,243,716
7409,330,0,2,0,106,36,290,764
7410,326,0,2,0,106,36,235,705
7411,326,0,2,0,106,36,281,751
7412,327,0,2,0,106,36,206,677
7413,327,0,2,0,106,36,211,682
7414,327,0,2,0,106,36,183,654
7415,329,0,2,0,106,35,196,668
7416,329,1,2,0,106,36,204,678
7417,329,1,2,0,106,36,387,861
7418,330,1,2,0,106,36,223,698
7419,331,1,2,1,107,36,242,720
7420,330,0,14,0,106,36,214,700
7421,330,0,13,0,106,35,219,703
7422,330,0,2,0,106,36,236,710
7423,332,0,3,0,106,37,231,709
7424,332,0,2,0,107,36,216,693
7425,331,0,2,0,106,36,210,685
7426,330,0,2,0,105,35,198,670
7427,330,0,2,0,106,35,196,669
7428,330,1,2,0,106,35,246,720
7429,328,0,2,0,106,37,261,734
7430,327,1,2,0,106,35,206,677
7431,328,0,2,0,106,36,206,678
7432,327,0,13,0,106,36,213,695
7433,327,0,13,0,107,36,217,700
7434,327,1,0,0,105,36,191,660
7435,329,0,0,0,106,36,188,659
7436,329,0,0,0,106,36,207,678
7437,329,0,0,0,106,36,239,710
7438,329,0,0,141,106,36,213,825
7439,329,0,0,128,106,36,222,821
7440,329,0,0,126,105,36,216,812
7441,329,0,0,125,105,36,240,835
7442,328,0,0,125,114,1388,252,2207
7443,326,0,0,123,113,1581,237,2380
7444,329,0,0,122,115,1674,214,2454
7445,328,0,0,122,113,1691,247,2501
7446,329,1,0,121,115,1706,207,2479
7447,329,0,0,121,113,1725,192,2480
7448,328,0,0,0,114,1733,202,2377
7449,324,0,0,0,113,1751,218,2406
7450,325,0,0,0,113,1746,225,2409
7451,325,0,0,0,114,1760,262,2461
7452,324,0,0,0,113,1758,208,2403
7453,324,0,0,0,113,1778,210,2425
7454,326,0,0,0,113,1775,195,2409
7455,328,0,0,0,114,1777,185,2404
7456,325,0,0,0,113,1770,207,2415
7457,326,0,0,0,113,1778,208,2425
7458,325,0,0,0,113,1775,193,2406
7459,325,0,0,0,113,1777,189,2404
7460,329,1,0,0,106,0,206,642
7461,329,0,0,0,107,0,191,627
7462,329,0,0,0,106,1,209,645
7463,329,0,0,0,106,1,185,621
7464,328,0,0,8,107,1,208,652
7465,328,1,0,0,107,1,215,652
7466,329,0,0,0,106,1,182,618
7467,328,0,0,0,106,1,184,619
7468,329,1,0,0,106,1,202,639
7469,327,0,0,0,107,1,176,611
7470,328,1,0,0,107,1,194,631
7471,326,0,0,0,106,1,242,675
7472,327,1,0,0,106,0,181,615
7473,327,0,0,0,106,1,200,634
7474,327,0,0,0,106,1,198,632
7475,330,0,0,0,106,1,186,623
7476,330,1,0,0,106,41,210,688
7477,330,0,0,0,107,37,388,862
7478,330,0,0,149,107,36,232,854
7479,332,0,0,136,106,36,251,861
7480,331,0,0,127,106,36,260,860
7481,329,1,0,126,107,36,225,824
7482,329,1,0,125,106,36,260,857
7483,329,0,0,124,106,36,235,830
7484,331,0,0,123,106,36,366,962
7485,330,0,0,124,106,37,247,844
7486,329,1,0,122,107,36,258,853
7487,330,0,0,121,106,36,234,827
7488,330,1,0,0,106,38,286,761
7489,328,0,0,0,106,36,239,709
7490,329,0,0,0,106,36,246,717
7491,329,0,0,0,106,36,347,818
7492,330,0,0,0,107,37,255,729
7493,331,0,0,6,106,37,286,766
7494,331,0,0,6,106,37,226,706
7495,330,4967,0,7,106,36,312,5758
7496,330,4615,0,7,106,36,228,5322
7497,331,4590,0,7,105,36,212,5281
7498,331,4613,0,7,106,36,254,5347
7499,332,4604,0,7,106,37,226,5312
7500,328,4581,0,7,106,36,272,5330
7501,330,242,0,7,106,37,339,1061
7502,332,246,0,7,106,38,230,959
7503,332,246,0,154,105,36,249,1122
7504,329,4591,0,141,106,36,237,5440
7505,329,4584,0,135,106,36,232,5422
7506,331,4598,0,134,106,36,221,5426
7507,334,242,0,133,107,37,232,1085
7508,335,231,0,134,106,37,263,1106
7509,327,4591,0,132,106,37,222,5415
7510,327,4576,0,131,106,36,228,5404
7511,332,236,0,131,106,37,223,1065
7512,331,237,0,130,106,37,223,1064
7513,332,242,0,130,106,36,238,1084
7514,329,4596,0,129,106,37,269,5466
7515,331,4620,0,129,106,37,380,5603
7516,336,243,0,129,106,37,384,1235
7517,336,243,0,130,106,36,252,1103
7518,336,245,0,129,106,36,374,1226
7519,338,245,0,128,106,36,235,1088
7520,338,244,0,128,105,38,288,1141
7521,337,250,0,127,106,36,253,1109
7522,336,252,0,127,106,37,247,1105
7523,337,252,0,7,106,37,247,986
7524,337,251,0,0,106,38,234,966
7525,337,253,0,0,106,37,326,1059
7526,332,0,0,0,106,37,254,729
7527,330,0,0,0,106,36,265,737
7528,331,0,0,0,106,36,300,773
7529,329,0,0,0,105,36,221,691
7530,329,0,0,0,106,37,238,710
7531,328,0,0,0,114,989,225,1656
7532,328,0,0,0,115,1541,223,2207
7533,327,0,0,0,115,1648,372,2462
7534,329,0,0,0,114,1720,230,2393
7535,328,0,0,0,113,1713,222,2376
7536,328,0,0,0,113,1719,224,2384
7537,328,0,0,0,114,1731,235,2408
7538,329,0,0,0,113,1741,213,2396
7539,329,0,0,0,113,1743,305,2490
7540,328,1,0,0,114,1758,218,2419
7541,327,0,0,0,113,1762,213,2415
7542,326,0,0,146,113,1766,217,2568
7543,326,0,0,132,113,1766,246,2583
7544,326,0,0,125,113,1774,351,2689
7545,326,0,0,126,113,1779,294,2638
7546,328,0,0,124,114,1776,244,2586
7547,327,1,0,123,114,1776,225,2566
7548,328,0,0,122,113,1781,230,2574
7549,328,0,0,122,113,1783,232,2578
7550,330,0,0,121,113,1783,224,2571
7551,330,0,0,0,114,1784,228,2456
7552,7,6,0,0,113,1789,37,1952
7553,7,4636,0,0,108,1,37,4789
7554,7,4649,0,0,107,1,37,4801
7555,7,4650,0,1,107,1,37,4803
7556,7,4631,0,0,107,1,38,4784
7557,7,4616,0,0,107,1,37,4768
7558,7,4642,0,1,106,1,37,4794
7559,7,4645,0,0,107,1,38,4798
7560,7,4661,0,1,107,1,37,4814
7561,7,4658,0,1,106,1,38,4811
7562,7,4649,0,0,107,0,39,4802
7563,7,4642,0,1,107,1,38,4796
7564,7,4655,0,0,106,1,38,4807
7565,7,4645,0,1,106,1,39,4799
7566,7,4646,0,1,108,1,38,4801
7567,7,4645,0,0,106,1,38,4797
7568,7,4645,0,0,106,1,38,4797
7569,7,4653,0,1,106,39,38,4844
7570,7,4636,0,0,106,38,38,4825
7571,7,4641,0,1,106,37,39,4831
7572,7,4661,0,1,107,38,38,4852
7573,7,4655,0,1,107,37,39,4846
7574,7,255,0,0,107,38,39,446
7575,7,247,0,0,106,38,38,436
7576,7,4672,0,0,107,36,39,4861
7577,7,4652,0,0,106,37,38,4840
7578,7,247,0,0,106,38,39,437
7579,7,252,0,0,106,38,39,442
7580,7,4640,0,0,108,37,39,4831
7581,7,247,0,0,106,38,39,437
7582,7,253,0,0,106,37,38,441
7583,7,255,0,7,106,37,38,450
7584,7,254,0,0,107,38,39,445
7585,7,249,0,0,106,37,38,437
7586,7,245,0,145,106,38,39,580
7587,7,249,0,132,106,37,38,569
7588,7,253,0,128,107,37,39,571
7589,7,257,0,127,106,37,38,572
7590,7,255,0,127,106,38,39,572
7591,7,1,0,125,107,36,39,315
7592,7,0,0,124,106,37,38,312
7593,7,0,0,123,107,38,38,313
7594,7,1,0,122,115,1501,39,1785
7595,7,0,0,122,114,1642,39,1924
7596,7,0,0,0,114,1722,39,1882
7597,7,0,0,0,115,1717,38,1877
7598,7,0,0,0,115,1728,39,1889
7599,7,0,0,0,115,1738,39,1899
7600,7,0,0,1,114,1747,38,1907
7601,7,0,0,0,115,1753,38,1913
7602,7,0,0,0,114,1757,39,1917
7603,7,0,0,0,114,1762,39,1922
7604,7,0,0,0,114,1767,38,1926
7605,7,0,0,0,114,1775,39,1935
7606,7,0,0,0,114,1775,39,1935
7607,7,1,0,0,115,1775,38,1936
7608,7,0,0,0,115,1778,39,1939
7609,7,0,0,1,115,1782,38,1943
7610,7,1,0,0,114,1785,38,1945
7611,7,0,0,0,115,1785,38,1945
7612,7,0,0,1,114,1786,39,1947
7613,7,0,0,0,115,1790,38,1950
7614,7,0,0,0,115,1785,39,1946
7615,7,1,0,0,115,1791,38,1952
7616,7,2,0,0,115,1794,38,1956
7617,7,0,0,0,115,1797,38,1957
7618,7,0,0,0,115,1797,38,1957
7619,7,0,0,0,115,1791,38,1951
7620,7,0,0,0,115,1794,38,1954
7621,7,0,0,0,115,1795,40,1957
7622,7,0,0,0,115,1799,38,1959
7623,7,1,0,0,108,1,39,156
7624,7,0,0,0,107,1,38,153
7625,7,1,0,0,107,1,38,154
7626,7,1,0,0,107,1,39,155
7627,7,0,0,0,106,1,39,153
7628,7,0,0,0,107,0,38,152
7629,7,1,0,0,106,1,38,153
7630,7,0,0,0,106,1,38,152
7631,7,0,0,144,108,1,38,298
7632,7,0,0,131,106,1,38,283
7633,7,0,0,127,107,0,39,280
7634,7,0,0,128,106,1,39,281
7635,7,1,0,126,107,1,38,280
7636,7,1,0,125,108,1,39,281
7637,7,0,0,124,107,1,39,278
7638,7,0,0,125,107,1,38,278
7639,7,1,0,123,107,39,39,316
7640,7,0,0,0,106,38,39,190
7641,7,0,0,0,106,37,38,188
7642,7,0,0,0,107,38,38,190
7643,7,0,0,0,106,37,39,189
7644,7,0,0,10,106,37,39,199
7645,7,0,0,0,107,38,38,190
7646,7,0,0,0,108,38,39,192
7647,7,0,0,0,106,37,38,188
7648,7,0,0,0,108,37,38,190
7649,7,0,0,0,108,36,38,189
7650,7,0,0,0,107,37,39,190
7651,7,1,0,0,106,38,38,190
7652,7,1,0,0,108,37,38,191
7653,7,0,0,0,107,37,39,190
7654,7,0,0,1,106,1007,38,1159
7655,7,0,0,0,115,1532,38,1692
7656,7,0,0,0,114,1673,39,1833
7657,7,0,0,0,114,1736,39,1896
7658,7,0,0,0,115,1727,38,1887
7659,7,0,0,0,114,1738,38,1897
7660,7,0,0,0,114,1745,39,1905
7661,7,0,0,0,115,1751,38,1911
7662,7,0,0,0,115,1754,38,1914
7663,7,0,0,0,115,1762,38,1922
7664,7,0,0,1,114,1765,39,1926
7665,7,0,0,0,114,1773,38,1932
7666,7,0,0,0,114,1771,39,1931
7667,7,0,0,0,114,1778,39,1938
7668,7,0,0,10,114,1779,38,1948
7669,7,0,0,7,114,1782,38,1948
7670,7,1,0,151,114,1785,38,2096
7671,7,1,0,136,114,1786,39,2083
7672,7,0,0,136,114,1790,39,2086
7673,7,0,0,133,115,1785,38,2078
7674,7,1,0,133,114,1791,38,2084
7675,7,0,0,132,115,1791,38,2083
7676,7,0,0,132,114,1790,39,2082
7677,7,2,0,131,114,1793,38,2085
7678,7,1,0,131,114,1794,39,2086
7679,7,0,0,131,115,1799,39,2091
7680,7,0,0,131,115,1798,39,2090
7681,7,0,0,131,114,1799,39,2090
7682,7,1,0,130,115,1797,38,2088
7683,7,1,0,130,115,1792,38,2083
7684,7,0,0,129,108,1,39,284
7685,7,0,0,129,107,1,38,282
7686,7,0,0,130,107,1,38,283
7687,7,0,0,128,107,1,39,282
7688,7,0,0,7,108,1,39,162
7689,7,0,0,7,108,1,38,161
7690,7,1,0,7,107,1,38,161
7691,7,0,0,7,107,1,38,160
7692,7,1,0,7,106,1,40,162
7693,7,0,0,7,107,0,38,159
7694,7,0,0,7,106,1,39,160
7695,7,0,0,7,107,1,38,160
7696,7,0,0,10,106,1,38,162
7697,7,1,0,0,106,1,38,153
7698,7,0,0,130,107,1,39,284
7699,7,0,0,143,106,1,38,295
7700,7,0,0,132,106,38,39,322
7701,7,0,0,130,107,38,39,321
7702,7,0,0,128,106,37,38,316
7703,7,0,0,126,106,38,38,315
7704,7,0,0,125,106,37,39,314
7705,7,0,0,125,105,36,38,311
7706,7,0,0,124,106,37,38,312
7707,7,0,0,123,106,36,38,310
7708,7,0,0,122,108,38,39,314
7709,7,1,0,0,107,37,38,190
7710,7,0,0,0,106,36,39,188
7711,7,0,0,0,106,36,38,187
7712,7,0,0,0,107,36,38,188
7713,7,1,0,0,106,37,38,189
7714,7,2,0,0,108,36,38,191
7715,7,0,0,0,106,37,38,188
7716,7,1,0,0,107,38,39,192
7717,7,0,0,1,115,1522,39,1684
7718,7,0,0,0,115,1669,39,1830
7719,7,0,0,0,114,1736,39,1896
7720,7,0,0,0,115,1747,39,1908
7721,7,0,0,0,115,1727,38,1887
7722,7,1,0,1,114,1739,39,1901
7723,7,0,0,1,115,1743,39,1905
7724,7,0,0,0,115,1752,39,1913
7725,7,0,0,0,115,1760,39,1921
7726,7,0,0,1,114,1766,38,1926
7727,7,0,0,0,114,1769,39,1929
7728,7,1,0,0,114,1771,39,1932
7729,7,0,0,0,114,1777,39,1937
7730,7,0,0,0,115,1779,39,1940
7731,7,1,0,1,115,1783,38,1945
7732,7,1,0,0,115,1784,39,1946
7733,7,0,0,1,114,1783,39,1944
7734,7,0,0,0,114,1785,39,1945
7735,7,0,0,0,114,1792,39,1952
7736,7,0,0,0,113,1787,39,1946
7737,7,0,0,0,114,1787,39,1947
7738,7,0,0,0,114,1789,39,1949
7739,7,0,0,0,115,1792,39,1953
7740,7,0,0,0,114,1798,38,1957
7741,7,1,0,0,114,1795,38,1955
7742,7,1,0,1,114,1793,38,1954
7743,8,0,0,296,115,1793,38,2250
7744,7,0,0,140,113,1797,38,2095
7745,7,0,0,128,114,1798,38,2085
7746,7,0,0,127,114,1795,39,2082
7747,7,0,0,126,114,1794,38,2079
7748,7,0,0,125,115,1799,39,2085
7749,7,0,0,125,114,1803,38,2087
7750,7,0,0,124,108,1,38,278
7751,7,0,0,123,107,0,38,275
7752,7,0,0,123,108,0,39,277
7753,7,0,0,0,107,1,39,154
7754,7,0,0,0,107,1,38,153
7755,7,1,0,0,107,1,39,155
7756,7,1,0,11,106,1,39,165
7757,7,0,0,10,106,1,38,162
7758,7,0,0,0,107,1,39,154
7759,7,0,0,0,107,1,39,154
7760,7,0,0,0,106,1,38,152
7761,7,0,0,1,107,1,38,154
7762,7,0,0,1,107,1,38,154
7763,7,0,0,0,107,1,38,153
7764,7,1,0,1,106,1,38,154
7765,7,0,0,0,107,0,39,153
7766,7,0,0,1,107,0,39,154
7767,7,0,0,0,106,38,39,190
7768,7,0,0,1,107,38,38,191
7769,7,1,0,0,107,38,39,192
7770,7,0,0,0,106,38,38,189
7771,7,0,0,0,106,38,38,189
7772,7,0,0,0,106,37,39,189
7773,7,0,0,0,106,37,39,189
7774,7,0,0,0,106,36,39,188
7775,7,0,0,0,106,38,38,189
7776,7,0,0,0,107,38,39,191
7777,7,1,0,0,106,37,38,189
7778,7,0,0,0,106,38,38,189
7779,7,0,0,0,106,38,39,190
7780,7,0,0,0,107,38,38,190
7781,7,0,0,1,106,37,39,190
7782,7,0,0,924,104,38,39,1112
7783,7,0,0,142,108,37,38,332
7784,7,0,0,130,107,37,38,319
7785,7,0,0,128,107,37,38,317
7786,7,0,0,126,107,37,39,316
7787,7,0,0,127,107,37,38,316
7788,7,0,0,124,114,1505,38,1788
7789,7,0,0,123,115,1663,38,1946
7790,7,1,0,123,116,1734,38,2019
7791,7,0,0,122,115,1725,39,2008
7792,7,1,0,0,115,1734,39,1896
7793,7,0,0,0,115,1742,38,1902
7794,7,0,0,1,114,1741,38,1901
7795,7,0,0,0,115,1758,38,1918
7796,7,1,0,0,114,1760,38,1920
7797,7,1,0,1,114,1767,38,1928
7798,7,0,0,0,114,1773,39,1933
7799,7,0,0,0,115,1773,39,1934
7800,7,1,0,0,114,1776,38,1936
7801,7,2,0,0,114,1779,39,1941
7802,7,0,0,0,115,1782,39,1943
7803,7,0,0,1,114,1784,39,1945
7804,7,0,0,0,114,1790,38,1949
7805,7,0,0,0,115,1787,38,1947
7806,7,1,0,1,114,1785,38,1946
7807,7,0,0,0,115,1790,40,1952
7808,7,0,0,0,115,1791,39,1952
7809,7,0,0,0,114,1790,39,1950
7810,7,0,0,0,114,1794,39,1954
7811,7,0,0,0,114,1794,39,1954
7812,7,1,0,0,114,1789,39,1950
7813,7,1,0,0,115,1797,38,1958
7814,7,0,0,0,115,1794,38,1954
7815,7,0,0,1,115,1799,38,1960
7816,7,0,0,1,116,1798,39,1961
7817,7,1,0,10,114,1798,39,1969
7818,7,0,0,7,114,1805,38,1971
7819,7,0,0,0,114,1800,38,1959
7820,7,0,0,0,114,1799,38,1958
7821,7,1,0,0,114,1802,39,1963
7822,7,0,0,0,114,1800,38,1959
7823,7,0,0,0,114,1799,38,1958
7824,7,0,0,150,114,1806,39,2116
7825,7,0,0,135,114,1802,39,2097
7826,7,1,0,130,108,174,39,459
7827,7,0,0,127,106,0,38,278
7828,7,1,0,127,108,1,39,283
7829,7,1,0,126,107,1,38,280
7830,7,0,0,125,107,1,38,278
7831,7,0,0,123,107,1,38,276
7832,7,0,0,124,106,0,38,275
7833,7,0,0,122,106,1,39,275
7834,7,0,0,1,107,1,39,155
7835,7,0,0,0,106,1,39,153
7836,7,0,0,0,106,1,38,152
7837,7,0,0,0,107,0,38,152
7838,7,0,0,0,106,1,39,153
7839,7,0,0,0,106,1,39,153
7840,7,0,0,0,106,1,39,153
7841,7,0,0,0,106,1,38,152
7842,7,0,0,1,108,1,39,156
7843,7,0,0,0,106,38,38,189
7844,7,0,0,0,106,38,38,189
7845,7,0,0,0,106,38,38,189
7846,7,0,0,0,107,38,38,190
7847,7,0,0,0,106,38,39,190
7848,7,1,0,1,106,37,38,190
7849,7,0,0,7,106,38,38,196
7850,7,0,0,7,106,38,39,197
7851,7,0,0,7,106,38,38,196
7852,7,0,0,7,106,38,39,197
7853,7,0,0,7,107,38,38,197
7854,7,0,0,7,107,37,39,197
7855,7,1,0,7,106,36,38,195
7856,7,0,0,155,107,36,38,343
7857,7,1,0,140,106,37,39,330
7858,7,0,0,135,106,37,38,323
7859,7,0,0,134,105,37,39,322
7860,7,1,0,134,106,38,38,324
7861,7,0,0,132,107,38,38,322
7862,7,1,0,133,115,1473,39,1768
7863,7,0,0,132,115,1642,39,1935
7864,7,0,0,131,115,1721,39,2013
7865,7,1,0,131,115,1711,38,2003
7866,7,0,0,130,115,1723,38,2013
7867,7,0,0,130,115,1743,38,2033
7868,7,0,0,130,114,1752,38,2041
7869,7,1,0,130,114,1754,39,2045
7870,7,0,0,130,114,1757,38,2046
7871,7,0,0,128,115,1757,38,2045
7872,7,0,0,128,114,1767,39,2055
7873,7,1,0,127,114,1778,38,2065
7874,7,0,0,127,114,1783,38,2069
7875,7,0,0,127,114,1775,38,2061
7876,7,0,0,7,115,1776,39,1944
7877,7,0,0,7,114,1781,39,1948
7878,7,0,0,0,115,1781,38,1941
7879,7,0,0,0,113,1781,38,1939
7880,7,0,0,0,114,1781,38,1940
7881,7,1,0,0,115,1791,38,1952
7882,7,0,0,0,114,1790,38,1949
7883,7,1,0,0,114,1784,38,1944
7884,7,0,0,0,113,1781,38,1939
7885,7,0,0,0,113,1791,39,1950
7886,7,1,0,0,114,1792,39,1953
7887,7,1,0,0,114,1799,38,1959
7888,7,0,0,0,115,1795,39,1956
7889,7,1,0,149,114,1787,39,2097
7890,7,0,0,135,115,1795,39,2091
7891,7,2,0,127,114,1792,38,2080
7892,7,0,0,127,114,1793,38,2079
7893,7,1,0,125,114,1794,38,2079
7894,7,0,0,125,113,1806,39,2090
7895,7,1,0,124,114,1800,39,2085
7896,7,0,0,124,114,1797,39,2081
7897,7,1,0,122,115,1797,39,2081
7898,7,1,0,121,115,1799,39,2082
7899,7,0,0,0,114,1798,39,1958
7900,7,0,0,0,114,1800,39,1960
7901,7,0,0,0,115,1801,39,1962
7902,7,1,0,0,108,1,39,156
7903,7,1,0,0,107,1,39,155
7904,7,1,0,0,107,1,39,155
7905,7,0,0,1,107,1,38,154
7906,7,1,0,0,106,1,39,154
7907,7,0,0,0,108,1,39,155
7908,7,0,0,0,106,1,38,152
7909,7,0,0,0,106,1,39,153
7910,7,1,0,1,106,1,38,154
7911,7,0,0,0,107,1,39,154
7912,7,1,0,0,107,0,38,153
7913,7,0,0,0,106,0,38,151
7914,7,0,0,0,107,1,38,153
7915,7,1,0,0,108,1,38,155
7916,7,0,0,0,106,1,39,153
7917,7,0,0,1,106,1,38,153
7918,7,0,0,0,106,41,39,193
7919,7,0,0,1,107,39,38,192
7920,7,0,0,0,107,37,38,189
7921,7,0,0,1,107,37,39,191
7922,7,0,0,0,106,36,38,187
7923,7,0,0,0,106,38,38,189
7924,7,1,0,0,106,37,38,189
7925,7,0,0,0,107,37,39,190
7926,7,0,0,0,106,38,39,190
7927,7,0,0,0,106,38,38,189
7928,7,0,0,0,106,37,38,188
7929,7,0,0,0,106,38,39,190
7930,7,0,0,1,108,37,39,192
7931,7,0,0,0,108,37,39,191
7932,7,1,0,0,107,37,39,191
7933,7,0,0,0,107,37,39,190
7934,7,0,0,149,107,36,38,337
7935,7,0,0,136,106,36,38,323
7936,7,1,0,127,107,38,39,319
7937,7,0,0,128,107,39,38,319
7938,7,0,0,130,116,1511,38,1802
7939,7,0,0,126,115,1670,38,1956
7940,7,0,0,125,114,1720,38,2004
7941,7,0,0,124,116,1743,39,2029
7942,7,0,0,122,115,1725,38,2007
7943,7,1,0,123,115,1737,39,2022
7944,7,0,0,0,115,1741,39,1902
7945,7,1,0,0,115,1751,38,1912
7946,7,0,0,0,114,1761,39,1921
7947,7,0,0,0,114,1770,38,1929
7948,7,1,0,0,115,1769,38,1930
7949,7,1,0,0,114,1775,38,1935
7950,7,0,0,0,114,1779,38,1938
7951,7,1,0,0,114,1777,39,1938
7952,7,1,0,0,114,1778,39,1939
7953,7,1,0,0,114,1786,39,1947
7954,7,0,0,0,115,1785,39,1946
7955,7,1,0,0,115,1785,38,1946
7956,7,1,0,0,115,1787,38,1948
7957,7,0,0,0,114,1789,39,1949
7958,7,0,0,0,115,1794,38,1954
7959,7,1,0,0,114,1791,39,1952
7960,7,1,0,0,114,1794,38,1954
7961,7,0,0,0,114,1795,39,1955
7962,7,0,0,0,115,1801,39,1962
7963,7,0,0,0,114,1801,38,1960
7964,7,0,0,0,115,1805,39,1966
7965,7,0,0,0,115,1802,38,1962
7966,7,0,0,0,114,1805,39,1965
7967,7,1,0,0,115,1801,39,1963
7968,7,0,0,1,114,1803,38,1963
7969,7,1,0,0,114,1807,39,1968
7970,7,0,0,0,114,1806,38,1965
7971,7,1,0,1,114,1805,39,1967
7972,7,0,0,0,114,1805,39,1965
7973,7,1,0,0,114,1808,38,1968
7974,7,0,0,1,114,1810,38,1970
7975,7,0,0,0,114,1811,39,1971
7976,7,0,0,0,114,1810,40,1971
7977,7,0,0,0,114,1811,39,1971
7978,7,0,0,0,114,1816,39,1976
7979,7,0,0,143,109,1,38,298
7980,7,0,0,130,107,1,38,283
7981,7,0,0,128,106,0,39,280
7982,7,0,0,126,107,1,38,279
7983,7,1,0,127,107,1,38,281
7984,7,0,0,125,106,0,39,277
7985,7,0,0,123,107,1,38,276
7986,7,0,0,122,107,1,38,275
7987,7,0,0,122,106,1,38,274
7988,7,1,0,0,107,1,39,155
7989,7,0,0,0,106,1,38,152
7990,7,0,0,0,106,1,38,152
7991,7,0,0,0,108,1,39,155
7992,7,0,0,1,107,1,38,154
7993,7,0,0,0,107,1,39,154
7994,7,0,0,0,106,1,39,153
7995,7,0,0,0,106,1,39,153
7996,7,1,0,0,106,15,39,168
7997,7,1,0,0,106,39,38,191
7998,7,0,0,10,106,38,38,199
7999,7,0,0,10,107,39,38,201
8000,7,0,0,0,106,38,38,189
8001,7,0,0,0,105,38,38,188
8002,7,0,0,0,106,37,39,189
8003,7,0,0,0,107,37,38,189
8004,7,0,0,1,106,37,38,189
8005,7,1,0,0,107,38,39,192
8006,7,2,0,0,106,38,39,192
8007,7,0,0,0,106,38,38,189
8008,7,0,0,0,106,38,38,189
8009,7,0,0,0,106,37,39,189
8010,7,0,0,0,107,38,38,190
8011,7,0,0,0,106,38,39,190
8012,7,0,0,0,107,37,38,189
8013,7,1,0,0,107,36,39,190
8014,7,0,0,1,106,37,39,190
8015,7,1,0,0,108,36,38,190
8016,7,0,0,0,107,37,38,189
8017,7,0,0,1,106,37,38,189
8018,7,0,0,143,108,37,39,334
8019,7,0,0,141,106,37,39,330
8020,7,0,0,128,115,1333,38,1621
8021,7,1,0,127,114,1616,39,1904
8022,7,0,0,127,115,1696,39,1984
8023,7,0,0,125,114,1719,38,2003
8024,7,0,0,123,115,1749,39,2033
8025,7,0,0,124,115,1722,39,2007
8026,7,0,0,123,115,1735,38,2018
8027,7,0,0,122,114,1743,38,2024
8028,7,1,0,0,115,1753,39,1915
8029,7,0,0,0,114,1759,39,1919
8030,7,0,0,0,115,1763,39,1924
8031,7,1,0,0,114,1769,38,1929
8032,7,0,0,0,115,1776,39,1937
8033,7,0,0,0,114,1775,38,1934
8034,7,1,0,10,115,1781,38,1952
8035,7,0,0,7,114,1784,39,1951
8036,7,0,0,7,114,1786,39,1953
8037,7,0,0,7,114,1786,38,1952
8038,7,0,0,7,115,1787,39,1955
8039,7,0,0,7,114,1791,38,1957
8040,7,0,0,7,113,1792,39,1958
8041,7,0,0,7,115,1791,38,1958
8042,7,1,0,7,113,1790,39,1957
8043,7,0,0,7,114,1797,38,1963
8044,7,0,0,7,113,1797,39,1963
8045,7,1,0,146,114,1797,39,2104
8046,7,0,0,137,114,1797,38,2093
8047,7,0,0,135,114,1797,38,2091
8048,7,1,0,134,113,1795,38,2088
8049,7,0,0,133,114,1795,39,2088
8050,7,0,0,132,114,1803,38,2094
8051,7,1,0,132,113,1799,38,2090
8052,7,0,0,131,113,1802,38,2091
8053,7,0,0,131,113,1801,38,2090
8054,7,0,0,130,114,1801,38,2090
8055,7,1,0,131,113,1803,37,2092
8056,7,0,0,129,113,1806,38,2093
8057,7,1,0,130,114,1806,38,2096
8058,7,1,0,128,113,1806,38,2093
8059,7,1,0,128,114,1806,38,2094
8060,7,1,0,128,113,1807,38,2094
8061,7,1,0,127,113,1807,38,2093
8062,7,0,0,127,113,1810,38,2095
8063,7,0,0,127,113,1813,38,2098
8064,7,2,0,10,114,1810,38,1981
8065,7,0,0,0,113,1811,39,1970
8066,7,1,0,0,113,1816,39,1976
8067,7,0,0,0,106,1,39,153
8068,7,0,0,0,107,1,39,154
8069,7,1,0,0,106,1,38,153
8070,7,1,0,0,106,0,38,152
8071,7,0,0,1,107,1,39,155
8072,7,0,0,0,106,1,39,153
8073,7,0,0,1,106,1,38,153
8074,7,0,0,0,106,1,39,153
8075,7,0,0,0,107,1,38,153
8076,7,0,0,0,106,1,38,152
8077,7,0,0,0,106,0,38,151
8078,7,0,0,0,106,1,39,153
8079,7,0,0,0,106,1,38,152
8080,7,1,0,0,106,0,38,152
8081,7,0,0,0,107,1,39,154
8082,7,0,0,0,107,1,39,154
8083,7,0,0,0,107,1,39,154
8084,7,0,0,142,106,1,39,295
8085,7,0,0,129,107,41,38,322
8086,7,0,0,127,106,38,38,316
8087,7,1,0,124,106,38,38,314
8088,7,0,0,125,106,36,38,312
8089,7,0,0,123,106,37,38,311
8090,7,0,0,123,106,37,39,312
8091,7,0,0,123,107,36,38,311
8092,7,0,0,121,106,36,38,308
8093,7,0,0,1,106,37,39,190
8094,7,0,0,1,106,37,38,189
8095,7,0,0,0,106,36,39,188
8096,7,0,0,0,106,38,38,189
8097,7,0,0,0,106,38,38,189
8098,7,0,0,0,114,1498,38,1657
8099,7,0,0,0,115,1672,38,1832
8100,7,0,0,0,114,1733,39,1893
8101,7,0,0,0,113,1754,39,1913
8102,7,0,0,0,114,1735,39,1895
8103,7,0,0,0,114,1746,39,1906
8104,7,0,0,0,114,1753,39,1913
8105,7,1,0,0,113,1767,38,1926
8106,7,0,0,1,113,1767,38,1926
8107,7,0,0,1,114,1777,39,1938
8108,7,0,0,0,115,1776,38,1936
8109,7,0,0,0,114,1787,39,1947
8110,7,0,0,0,114,1787,39,1947
8111,7,0,0,0,114,1792,38,1951
8112,7,0,0,0,114,1798,38,1957
8113,7,0,0,0,113,1795,39,1954
8114,7,0,0,0,115,1795,38,1955
8115,7,0,0,0,114,1800,38,1959
8116,7,0,0,0,115,1797,39,1958
8117,7,0,0,1,115,1802,39,1964
8118,7,0,0,0,114,1806,38,1965
8119,7,1,0,0,115,1806,39,1968
8120,7,0,0,0,114,1806,39,1966
8121,7,0,0,0,114,1807,39,1967
8122,7,1,0,0,113,1809,38,1968
8123,7,0,0,0,113,1802,38,1960
8124,7,0,0,10,114,1806,38,1975
8125,7,0,0,7,114,1808,38,1974
8126,7,0,0,1,113,1811,38,1970
8127,7,1,0,0,114,1815,39,1976
8128,7,1,0,143,115,1817,39,2122
8129,7,0,0,130,113,1816,38,2104
8130,7,0,0,128,114,1819,38,2106
8131,7,0,0,126,114,1818,39,2104
8132,7,0,0,125,107,1,39,279
8133,7,1,0,125,107,1,39,280
8134,7,1,0,124,106,1,38,277
8135,7,0,0,123,107,1,38,276
8136,7,0,0,122,107,0,38,274
8137,7,0,0,122,107,0,38,274
8138,7,1,0,1,106,1,38,154
8139,7,0,0,1,106,1,38,153
8140,7,0,0,1,106,1,38,153
8141,7,0,0,1,107,1,38,154
8142,7,0,0,1,107,0,38,153
8143,7,1,0,1,106,1,38,154
8144,7,0,0,0,106,0,39,152
8145,7,2,0,0,107,1,38,155
8146,7,1,0,0,106,1,39,154
8147,7,0,0,0,107,1,39,154
8148,7,0,0,0,106,1,39,153
8149,7,0,0,0,106,1,38,152
8150,7,0,0,0,106,38,39,190
8151,7,1,0,0,107,38,39,192
8152,7,0,0,0,106,38,38,189
8153,7,0,0,10,106,37,38,198
8154,7,0,0,7,106,38,38,196
8155,7,1,0,7,106,38,38,197
8156,7,0,0,7,107,38,38,197
8157,7,1,0,7,106,38,39,198
8158,7,0,0,7,106,38,39,197
8159,7,0,0,7,106,37,38,195
8160,7,0,0,152,107,37,37,340
8161,7,0,0,139,106,37,38,327
8162,7,0,0,136,107,38,39,327
8163,7,0,0,136,105,36,38,322
8164,7,1,0,135,106,37,38,324
8165,7,0,0,136,106,37,38,324
8166,7,0,0,134,105,36,39,321
8167,7,0,0,133,106,37,38,321
8168,7,0,0,132,106,36,38,319
8169,7,0,0,132,107,38,38,322
8170,7,0,0,131,106,37,39,320
8171,7,0,0,130,106,37,39,319
8172,7,0,0,132,106,37,39,321
8173,7,0,0,132,106,36,39,320
8174,7,1,0,132,106,37,38,321
8175,7,0,0,131,106,37,38,319
8176,7,0,0,131,107,36,39,320
8177,7,0,0,131,106,37,39,320
8178,7,0,0,130,107,36,38,318
8179,7,0,0,129,107,36,38,317
8180,7,0,0,129,106,36,39,317
8181,7,0,0,128,107,37,38,317
8182,7,0,0,128,108,37,40,320
8183,7,1,0,129,106,35,38,316
8184,7,0,0,130,107,37,39,320
8185,7,0,0,7,106,37,38,195
8186,7,1,0,7,106,37,39,197
8187,7,0,0,7,107,36,38,195
8188,7,0,0,7,106,37,38,195
8189,7,0,0,7,106,37,39,196
8190,7,0,0,7,107,36,39,196
8191,7,1,0,7,106,36,38,195
8192,7,0,0,7,106,36,39,195
8193,7,0,0,7,107,37,38,196
8194,7,0,0,159,114,1432,38,1750
8195,7,0,0,138,114,1641,39,1939
8196,7,0,0,211,114,1722,38,2092
8197,7,0,0,131,114,1713,38,2003
8198,7,0,0,128,114,1727,38,2014
8199,7,1,0,128,114,1738,39,2027
8200,7,1,0,125,114,1746,38,2031
8201,7,1,0,125,115,1752,39,2039
8202,7,1,0,124,114,1771,38,2055
8203,7,0,0,123,115,1771,39,2055
8204,7,0,0,122,114,1783,39,2065
8205,7,1,0,122,116,1781,38,2065
8206,7,0,0,0,114,1783,38,1942
8207,7,0,0,0,115,1794,39,1955
8208,7,0,0,0,114,1789,38,1948
8209,7,0,0,0,115,1805,38,1965
8210,7,0,0,0,115,1799,39,1960
8211,7,0,0,0,115,1802,39,1963
8212,7,0,0,0,115,1799,39,1960
8213,7,0,0,0,114,1808,39,1968
8214,7,0,0,0,115,1808,38,1968
8215,7,0,0,0,114,1802,38,1961
8216,7,0,0,0,114,1813,39,1973
8217,7,0,0,0,114,1806,39,1966
8218,7,1,0,0,115,1821,38,1982
8219,7,0,0,0,107,0,38,152
8220,7,1,0,0,106,1,38,153
8221,7,2,0,0,106,1,38,154
8222,7,0,0,1,107,1,39,155
8223,7,0,0,0,106,0,38,151
8224,7,0,0,0,107,1,38,153
8225,7,0,0,0,106,1,38,152
8226,7,0,0,0,106,1,39,153
8227,7,2,0,0,107,1,38,155
8228,7,1,0,1,107,1,39,156
8229,7,0,0,0,106,1,39,153
8230,7,1,0,0,106,1,38,153
8231,7,0,0,0,106,1,38,152
8232,7,1,0,0,106,1,38,153
8233,7,0,0,1,106,1,39,154
8234,7,0,0,0,107,1,39,154
8235,7,0,0,0,106,1,39,153
8236,7,0,0,0,106,1,38,152
8237,7,0,0,0,106,39,38,190
8238,7,0,0,0,106,37,38,188
8239,7,0,0,144,106,36,39,332
8240,7,1,0,131,107,37,38,321
8241,7,0,0,127,106,36,39,315
8242,7,0,0,127,106,37,39,316
8243,7,1,0,126,106,37,38,315
8244,7,1,0,126,106,37,39,316
8245,7,1,0,123,106,38,39,314
8246,7,1,0,122,106,38,39,313
8247,7,0,0,122,106,36,39,310
8248,7,0,0,121,106,36,38,308
8249,7,0,0,0,107,37,39,190
8250,7,0,0,0,107,36,39,189
8251,7,1,0,0,107,37,38,190
8252,7,0,0,0,107,37,39,190
8253,7,0,0,0,108,37,39,191
8254,7,0,0,10,106,36,39,198
8255,7,0,0,7,107,38,39,198
8256,7,0,0,0,107,37,38,189
8257,7,0,0,0,108,37,38,190
8258,7,1,0,0,106,37,38,189
8259,7,0,0,0,107,37,38,189
8260,7,1,0,0,106,37,38,189
8261,7,0,0,0,107,38,38,190
8262,7,0,0,0,106,37,39,189
8263,7,0,0,0,106,37,38,188
8264,7,1,0,1,106,37,38,190
8265,7,0,0,0,106,37,39,189
8266,7,1,0,0,106,36,39,189
8267,7,1,0,0,106,36,39,189
8268,7,0,0,0,107,37,39,190
8269,7,1,0,0,106,37,39,190
8270,7,0,0,0,106,36,38,187
8271,7,0,0,0,107,37,39,190
8272,7,0,0,0,106,36,38,187
8273,7,0,0,1,106,36,39,189
8274,7,0,0,0,106,38,38,189
8275,7,0,0,0,108,37,38,190
8276,7,0,0,0,108,36,38,189
8277,7,0,0,0,106,36,39,188
8278,6,0,0,880,104,36,39,1065
8279,7,0,0,140,107,36,38,328
8280,7,0,0,128,106,36,38,315
8281,7,0,0,129,106,36,39,317
8282,7,1,0,126,106,36,39,315
8283,7,0,0,126,106,36,39,314
8284,7,1,0,124,106,37,38,313
8285,7,0,0,124,106,36,39,312
8286,7,0,0,122,106,36,38,309
8287,7,0,0,121,105,36,38,307
8288,7,0,0,0,106,37,39,189
8289,7,0,0,0,106,37,38,188
8290,7,0,0,0,107,37,38,189
8291,7,1,0,0,106,37,39,190
8292,7,1,0,0,106,36,38,188
8293,7,0,0,0,106,37,39,189
8294,7,1,0,0,108,36,39,191
8295,7,0,0,1,106,37,38,189
8296,7,0,0,0,106,37,39,189
8297,7,0,0,0,106,36,38,187
8298,7,0,0,0,106,36,39,188
8299,7,0,0,0,107,37,39,190
8300,7,0,0,0,106,36,39,188
8301,7,0,0,0,106,37,39,189
8302,7,0,0,0,106,37,38,188
8303,7,0,0,0,106,37,38,188
8304,7,1,0,0,105,36,38,187
8305,7,0,0,0,106,36,39,188
8306,7,0,0,0,106,36,38,187
8307,7,0,0,0,106,36,38,187
8308,7,0,0,0,106,36,38,187
8309,7,1,0,0,106,35,38,187
8310,7,0,0,0,106,37,39,189
8311,7,0,0,0,106,36,38,187
8312,7,1,0,1,107,36,39,191
8313,7,0,0,0,106,37,38,188
8314,7,1,0,1,106,37,38,190
8315,7,1,0,7,106,36,39,196
8316,7,0,0,1,106,37,38,189
8317,7,0,0,0,106,37,39,189
8318,7,1,0,0,106,36,38,188
8319,7,1,0,0,106,35,38,187
8320,7,0,0,0,106,37,38,188
8321,7,0,0,149,106,36,39,337
8322,7,0,0,137,105,36,38,323
8323,7,0,0,128,106,37,38,316
8324,7,1,0,128,106,37,39,318
8325,7,0,0,126,106,37,38,314
8326,7,0,0,125,106,36,38,312
8327,7,1,0,124,106,37,39,314
8328,7,0,0,123,107,37,39,313
8329,7,1,0,122,106,37,38,311
8330,7,0,0,121,106,36,38,308
8331,7,1,0,0,106,37,38,189
8332,7,0,0,0,107,35,38,187
8333,7,1,0,1,105,36,39,189
8334,7,0,0,0,106,37,39,189
8335,7,0,0,0,106,38,39,190
8336,7,0,0,0,106,37,39,189
8337,7,0,0,7,106,37,38,195
8338,7,0,0,7,106,36,39,195
8339,7,0,0,7,106,36,39,195
8340,7,1,0,7,107,37,39,198
8341,7,1,0,7,106,37,39,197
8342,7,1,0,7,106,37,38,196
8343,7,1,0,7,106,37,39,197
8344,7,0,0,7,107,36,38,195
8345,7,1,0,7,108,37,38,198
8346,7,1,0,7,106,36,39,196
8347,7,1,0,147,106,38,39,338
8348,7,0,0,136,107,37,39,326
8349,7,1,0,136,106,37,39,326
8350,7,0,0,134,106,36,38,321
8351,7,0,0,133,106,37,38,321
8352,7,0,0,132,106,38,38,321
8353,7,0,0,132,106,36,38,319
8354,7,1,0,131,106,36,39,320
8355,7,0,0,131,106,35,38,317
8356,7,1,0,131,106,36,38,319
8357,7,0,0,131,106,36,38,318
8358,7,1,0,130,106,36,39,319
8359,7,0,0,129,106,36,39,317
8360,7,0,0,129,106,36,38,316
8361,7,1,0,130,107,37,38,320
8362,7,1,0,128,106,36,39,317
8363,7,0,0,128,106,35,38,314
8364,7,0,0,128,106,38,39,318
8365,7,0,0,127,106,36,38,314
8366,7,0,0,130,105,36,38,316
8367,7,1,0,1,106,37,38,190
8368,7,1,0,0,107,35,38,188
8369,7,0,0,0,106,36,39,188
8370,7,0,0,0,105,37,39,188
8371,7,0,0,0,106,37,38,188
8372,7,1,0,0,106,36,38,188
8373,7,0,0,0,106,36,38,187
8374,7,0,0,0,106,37,38,188
8375,7,0,0,0,106,35,38,186
8376,7,0,0,0,106,35,39,187
8377,7,0,0,0,107,37,38,189
8378,7,0,0,0,106,37,39,189
8379,7,0,0,0,106,36,38,187
8380,7,1,0,0,105,37,38,188
8381,7,0,0,0,106,36,38,187
8382,7,1,0,0,106,36,39,189
8383,7,0,0,0,106,36,38,187
8384,7,0,0,0,106,37,38,188
8385,7,0,0,0,106,37,38,188
8386,7,0,0,0,106,38,39,190
8387,7,0,0,0,105,36,38,186
8388,7,0,0,0,106,38,38,189
8389,7,0,0,0,106,36,39,188
8390,7,0,0,142,106,37,39,331
8391,7,0,0,130,107,37,39,320
8392,7,0,0,127,106,37,38,315
8393,7,0,0,126,106,36,38,313
8394,7,0,0,125,106,37,38,313
8395,7,0,0,124,106,36,38,311
8396,7,1,0,124,105,37,39,313
8397,7,0,0,122,107,37,39,312
8398,7,1,0,122,106,36,38,310
8399,7,0,0,0,106,37,39,189
8400,7,0,0,0,106,36,38,187
8401,7,1,0,0,106,36,39,189
8402,7,0,0,0,106,35,39,187
8403,7,0,0,1,106,37,39,190
8404,7,0,0,0,106,36,39,188
8405,7,0,0,0,106,37,38,188
8406,7,1,0,0,106,38,39,191
8407,7,0,0,0,105,35,39,186
8408,7,1,0,1,106,36,38,189
8409,7,0,0,0,106,37,39,189
8410,7,0,0,0,106,37,38,188
8411,7,1,0,0,106,36,38,188
8412,7,0,0,0,106,36,39,188
8413,7,2,0,0,106,37,38,190
8414,7,1,0,0,106,37,38,189
8415,7,0,0,0,106,36,39,188
8416,7,0,0,0,106,36,38,187
8417,7,0,0,0,106,37,39,189
8418,7,0,0,0,106,37,39,189
8419,7,0,0,0,106,36,39,188
8420,7,0,0,0,114,1378,38,1537
8421,7,1,0,0,114,1606,38,1766
8422,7,1,0,0,114,1677,39,1838
8423,7,0,0,0,114,1736,38,1895
8424,7,0,0,0,114,1753,39,1913
8425,7,0,0,0,114,1755,39,1915
8426,7,0,0,10,114,1781,39,1951
8427,7,0,0,7,114,1789,38,1955
8428,7,0,0,0,114,1797,39,1957
8429,7,0,0,0,115,1800,38,1960
8430,7,0,0,0,115,1803,38,1963
8431,7,1,0,0,114,1813,38,1973
8432,7,0,0,144,114,1793,38,2096
8433,7,1,0,131,114,1826,38,2117
8434,7,0,0,128,114,1821,38,2108
8435,7,1,0,127,114,1815,38,2102
8436,7,0,0,125,113,1811,39,2095
8437,7,0,0,124,114,1824,38,2107
8438,7,1,0,123,113,1818,38,2100
8439,7,1,0,122,114,1830,39,2113
8440,7,2,0,122,106,1,39,277
8441,7,0,0,122,107,1,38,275
8442,7,0,0,1,106,1,39,154
8443,7,0,0,0,106,0,38,151
8444,7,0,0,0,107,1,38,153
8445,7,1,0,0,108,0,38,154
8446,7,0,0,0,107,1,39,154
8447,7,1,0,0,107,1,39,155
8448,7,0,0,0,106,1,38,152
8449,7,0,0,0,106,1,38,152
8450,7,0,0,0,106,1,39,153
8451,7,0,0,0,106,1,38,152
8452,7,0,0,0,106,1,38,152
8453,7,0,0,1,106,1,39,154
8454,335,0,0,0,106,1,39,481
8455,335,1,0,0,106,1,288,731
8456,334,0,0,0,105,0,179,618
8457,334,0,0,0,106,1,248,689
8458,334,0,0,0,106,39,253,732
8459,335,0,0,0,107,38,254,734
8460,335,0,0,0,107,36,251,729
8461,334,1,0,0,107,37,182,661
8462,335,1,0,0,107,37,270,750
8463,334,0,0,0,107,38,286,765
8464,335,0,0,0,107,37,264,743
8465,335,0,0,0,107,37,265,744
8466,336,1,0,0,106,36,274,753
8467,334,0,0,0,106,36,269,745
8468,334,0,0,0,106,36,267,743
8469,334,0,0,0,106,37,282,759
8470,336,1,0,0,106,36,268,747
8471,334,1,0,0,106,37,235,713
8472,334,1,0,0,106,37,233,711
8473,334,0,0,0,106,38,244,722
8474,334,0,0,0,107,36,245,722
8475,334,0,0,0,107,38,261,740
8476,334,0,0,0,106,36,245,721
8477,336,0,0,0,106,37,265,744
8478,335,0,0,143,106,37,253,874
8479,335,1,0,130,107,37,241,851
8480,336,0,0,127,106,37,232,838
8481,337,0,0,126,106,38,251,858
8482,337,0,0,125,106,37,249,854
8483,336,0,0,124,107,37,242,846
8484,336,1,0,124,106,37,245,849
8485,336,0,0,122,106,37,244,845
8486,336,0,0,122,106,36,268,868
8487,336,0,0,123,106,37,254,856
8488,337,0,0,0,106,37,259,739
8489,338,1,0,0,106,38,254,737
8490,336,0,0,0,106,37,265,744
8491,337,0,0,0,107,38,231,713
8492,337,0,0,0,106,38,250,731
8493,337,0,0,0,107,36,295,775
8494,338,0,0,0,106,37,286,767
8495,336,1,0,0,106,37,290,770
8496,336,1,0,0,106,37,286,766
8497,335,1,0,0,106,37,275,754
8498,336,1,0,0,106,38,266,747
8499,336,1,0,0,106,37,278,758
8500,335,0,0,0,106,38,268,747
8501,334,1,0,0,107,38,269,749
8502,334,0,0,0,106,38,355,833
8503,334,1,0,0,107,37,325,804
8504,334,0,0,0,106,36,300,776
8505,333,1,0,0,106,36,276,752
8506,334,1,0,0,106,36,258,735
8507,334,0,0,0,106,38,250,728
8508,334,0,0,0,106,37,265,742
8509,334,0,0,0,106,37,278,755
8510,335,1,0,0,107,38,281,762
8511,335,1,0,0,107,36,272,751
8512,336,0,0,0,106,38,278,758
8513,335,0,0,10,106,38,274,763
8514,335,0,0,7,106,38,249,735
8515,335,0,0,7,107,37,265,751
8516,336,0,0,7,106,37,260,746
8517,335,0,0,134,106,36,269,880
8518,335,0,0,143,106,38,231,853
8519,337,1,0,135,106,36,265,880
8520,337,0,0,134,107,36,254,868
8521,337,0,0,133,106,37,239,852
8522,336,0,0,133,106,37,239,851
8523,337,1,0,132,107,38,263,878
8524,336,0,0,131,107,38,293,905
8525,337,1,0,132,107,37,299,913
8526,337,1,0,211,106,36,259,950
8527,337,0,0,213,108,38,278,974
8528,337,0,0,132,106,37,334,946
8529,338,0,0,133,106,37,255,869
8530,338,1,0,132,106,36,258,871
8531,338,0,0,132,106,37,257,870
8532,339,1,0,132,106,38,260,876
8533,337,0,0,132,106,37,234,846
8534,337,1,0,131,106,37,253,865
8535,336,0,0,131,107,36,260,870
8536,338,1,0,130,106,38,236,849
8537,337,1,0,129,106,36,227,836
8538,337,0,0,128,107,36,241,849
8539,337,0,0,129,106,37,250,859
8540,337,0,0,128,106,36,251,858
8541,336,0,0,128,106,37,261,868
8542,337,1,0,7,106,37,261,749
8543,338,0,0,7,106,36,252,739
8544,336,0,0,7,106,37,240,726
8545,335,0,0,7,106,37,249,734
8546,337,1,0,6,106,38,300,788
8547,336,1,0,7,106,36,302,788
8548,338,0,0,7,107,38,296,786
8549,337,0,0,7,106,37,311,798
8550,337,0,0,7,107,37,288,776
8551,336,0,0,155,105,37,272,905
8552,337,1,0,138,106,36,283,901
8553,337,0,0,137,107,37,211,829
8554,339,0,0,135,107,37,49,667
8555,338,1,0,134,107,37,49,666
8556,338,0,0,131,107,38,49,663
8557,338,0,0,129,106,37,49,659
8558,338,0,0,128,106,37,49,658
8559,338,0,0,126,107,38,49,658
8560,339,1,0,125,107,37,49,658
8561,7,0,0,125,106,37,49,324
8562,7,0,0,123,106,37,49,322
8563,7,1,0,123,106,38,49,324
8564,7,0,0,121,106,37,49,320
8565,7,0,0,0,106,38,49,200
8566,7,0,0,0,106,38,49,200
8567,7,0,0,0,106,37,49,199
8568,7,0,0,0,107,38,50,202
8569,7,1,0,1,108,38,49,204
8570,7,1,0,0,107,37,49,201
8571,7,0,0,0,106,38,49,200
8572,7,0,0,0,106,37,50,200
8573,7,1,0,0,106,38,49,201
8574,7,1,0,1,108,37,49,203
8575,7,0,0,1,107,37,49,201
8576,7,0,0,0,107,38,49,201
8577,7,0,0,1,106,37,50,201
8578,7,0,0,0,107,37,49,200
8579,7,0,0,1,106,38,39,191
8580,7,0,0,1,108,38,39,193
8581,7,0,0,0,106,37,39,189
8582,7,1,0,1,107,37,39,192
8583,7,0,0,1,106,37,38,189
8584,7,1,0,0,106,38,39,191
8585,7,2,0,0,107,38,39,193
8586,7,1,0,1,106,37,38,190
8587,7,1,0,0,107,37,39,191
8588,7,1,0,1,106,38,39,192
8589,7,0,0,1,107,38,38,191
8590,7,0,0,1,107,36,38,189
8591,7,0,0,0,107,37,38,189
8592,7,1,0,0,106,37,38,189
8593,7,0,0,0,108,37,38,190
8594,7,0,0,0,107,38,38,190
8595,7,0,0,1,107,38,39,192
8596,7,0,0,0,106,37,39,189
8597,7,0,0,147,106,38,38,336
8598,8,0,0,135,107,38,38,326
8599,7,0,0,128,106,37,39,317
8600,7,0,0,127,107,37,39,317
8601,7,0,0,127,107,38,39,318
8602,7,0,0,125,106,36,39,313
8603,7,0,0,124,108,36,38,313
8604,7,0,0,124,107,37,38,313
8605,7,0,0,123,106,37,38,311
8606,7,0,0,122,107,37,38,311
8607,7,1,0,1,106,36,39,190
8608,7,0,0,0,107,36,39,189
8609,7,0,0,0,106,37,39,189
8610,7,0,0,0,106,38,39,190
8611,7,0,0,0,108,36,39,190
8612,7,1,0,0,107,38,39,192
8613,7,1,0,0,106,38,39,191
8614,7,1,0,0,107,37,38,190
8615,7,0,0,1,106,38,38,190
8616,7,0,0,10,106,36,39,198
8617,7,0,0,0,107,36,39,189
8618,7,0,0,0,106,37,38,188
8619,7,0,0,0,106,36,39,188
8620,7,0,0,0,107,36,38,188
8621,7,0,0,0,106,37,39,189
8622,7,0,0,0,105,37,38,187
8623,7,0,0,0,106,36,38,187
8624,7,1,0,0,104,37,39,188
8625,7,0,0,0,105,37,38,187
8626,7,1,0,0,104,36,38,186
8627,7,0,0,1,106,37,38,189
8628,7,1,0,0,105,37,39,189
8629,7,1,0,0,106,37,38,189
8630,7,0,0,0,105,37,38,187
8631,7,0,0,1,104,37,39,188
8632,7,0,0,1,106,38,38,190
8633,7,1,0,0,106,37,38,189
8634,7,0,0,0,107,38,38,190
8635,7,0,0,0,104,36,38,185
8636,7,0,0,143,105,37,38,330
8637,7,1,0,131,105,37,38,319
8638,7,1,0,127,105,36,39,315
8639,7,0,0,127,106,37,39,316
8640,7,1,0,125,106,37,38,314
8641,7,1,0,124,104,36,38,310
8642,7,0,0,124,105,37,39,312
8643,7,0,0,123,104,37,38,309
8644,7,0,0,122,106,37,39,311
8645,7,0,0,122,105,37,39,310
8646,7,0,0,0,104,37,39,187
8647,7,0,0,0,105,35,38,185
8648,7,1,0,0,105,37,39,189
8649,7,0,0,0,105,37,39,188
8650,7,1,0,1,105,36,38,188
8651,7,0,0,0,105,37,38,187
8652,7,2,0,1,104,36,38,188
8653,7,0,0,0,105,36,38,186
8654,7,1,0,0,104,36,38,186
8655,7,0,0,0,105,37,39,188
8656,7,0,0,0,104,37,39,187
8657,7,1,0,10,106,37,39,200
8658,7,0,0,7,103,37,39,193
8659,7,0,0,7,104,37,39,194
8660,7,0,0,87,105,37,39,275
8661,7,0,0,7,106,36,39,195
8662,7,0,0,7,105,36,38,193
8663,7,1,0,7,107,36,39,197
8664,7,1,0,7,105,36,38,194
8665,7,0,0,155,107,37,38,344
8666,7,0,0,141,106,36,39,329
8667,7,0,0,138,106,36,38,325
8668,7,0,0,136,106,36,39,324
8669,7,0,0,136,106,36,38,323
8670,7,0,0,135,106,37,38,323
8671,7,0,0,134,106,36,38,321
8672,7,0,0,133,105,37,38,320
8673,7,0,0,132,106,36,38,319
8674,7,0,0,133,105,37,39,321
8675,7,0,0,131,106,37,38,319
8676,7,0,0,131,106,37,39,320
8677,7,1,0,131,106,36,38,319
8678,7,0,0,130,104,36,39,316
8679,7,0,0,129,106,36,39,317
8680,7,1,0,129,107,36,38,318
8681,7,0,0,129,106,37,39,318
8682,7,1,0,131,106,37,39,321
8683,7,0,0,128,105,37,38,315
8684,7,0,0,128,107,36,38,316
8685,7,0,0,127,106,37,38,315
8686,7,1,0,127,105,36,39,315
8687,7,0,0,7,105,37,38,194
8688,7,1,0,7,106,36,38,195
8689,7,0,0,7,106,36,39,195
8690,7,1,0,7,106,36,38,195
8691,7,0,0,0,106,37,38,188
8692,7,0,0,0,106,37,39,189
8693,7,0,0,1,106,36,39,189
8694,7,0,0,0,106,36,38,187
8695,7,1,0,1,106,37,38,190
8696,7,1,0,0,105,36,38,187
8697,7,0,0,0,105,37,39,188
8698,7,0,0,149,104,36,39,335
8699,7,1,0,134,106,36,38,322
8700,7,0,0,128,106,35,38,314
8701,7,1,0,127,106,37,39,317
8702,7,0,0,126,106,36,38,313
8703,7,0,0,124,106,36,38,311
8704,7,0,0,123,106,36,38,310
8705,7,0,0,123,106,37,38,311
8706,7,0,0,121,106,38,39,311
8707,7,1,0,121,106,37,38,310
8708,7,0,0,0,107,36,39,189
8709,7,0,0,0,107,36,38,188
8710,7,0,0,0,106,37,38,188
8711,7,0,0,0,106,36,39,188
8712,7,0,0,0,106,35,38,186
8713,7,1,0,1,106,36,39,190
8714,330,2,0,0,105,36,38,511
8715,329,1,0,0,105,36,38,509
8716,333,0,0,0,105,37,39,514
8717,327,1,0,0,106,36,38,508
8718,7,0,0,0,105,36,39,187
8719,7,0,0,0,106,36,39,188
8720,7,0,0,0,106,36,38,187
8721,7,0,0,0,106,36,39,188
8722,7,1,0,0,106,37,39,190
8723,7,1,0,1,106,36,38,189
8724,7,0,0,0,106,36,39,188
8725,7,1,0,0,378,2001,39,2426
8726,7,0,0,0,369,2206,39,2621
8727,7,1,0,0,366,2298,38,2710
8728,7,1,0,0,371,2352,39,2770
8729,7,0,0,0,366,2371,38,2782
8730,7,0,0,0,370,2388,38,2803
8731,7,1,0,0,371,2402,39,2820
8732,7,0,0,0,368,2412,38,2825
8733,7,1,0,0,364,2419,39,2830
8734,7,0,0,0,195,1,38,241
8735,7,0,0,1,106,1,38,153
8736,7,0,0,0,106,1,38,152
8737,7,0,0,0,107,1,38,153
8738,7,0,0,0,106,1,39,153
8739,7,1,0,0,108,1,38,155
8740,7,0,0,0,106,1,38,152
8741,7,0,0,0,106,1,38,152
8742,7,0,0,0,106,1,38,152
8743,7,1,0,1,106,1,39,155
8744,7,0,0,142,106,1,38,294
8745,7,0,0,131,105,1,39,283
8746,7,1,0,127,104,1,39,279
8747,7,0,0,127,106,1,39,280
8748,7,0,0,126,104,1,39,277
8749,7,0,0,125,105,1,39,277
8750,7,0,0,123,104,1,39,274
8751,7,0,0,128,106,1,39,281
8752,7,1,0,125,106,39,38,316
8753,7,0,0,122,106,38,38,311
8754,7,0,0,0,106,37,38,188
8755,7,0,0,0,106,37,39,189
8756,7,0,0,1,105,37,39,189
8757,7,0,0,1,104,37,38,187
8758,7,1,0,0,105,36,39,188
8759,7,0,0,0,104,35,38,184
8760,7,0,0,0,106,38,38,189
8761,7,0,0,0,104,37,39,187
8762,7,1,0,0,105,37,39,189
8763,7,1,0,0,106,37,38,189
8764,7,0,0,0,104,36,38,185
8765,7,0,0,7,106,37,38,195
8766,7,0,0,7,106,37,38,195
8767,7,0,0,7,104,35,38,191
8768,7,1,0,7,105,36,39,195
8769,7,0,0,749,104,37,39,936
8770,7,0,0,145,104,36,38,330
8771,7,0,0,139,105,36,38,325
8772,7,0,0,138,106,36,38,325
8773,7,0,0,137,106,35,38,323
8774,7,0,0,137,104,35,38,321
8775,7,0,0,136,105,36,38,322
8776,7,0,0,135,105,38,39,324
8777,7,0,0,134,106,36,38,321
8778,7,1,0,133,105,34,39,319
8779,8,0,0,132,106,37,39,322
8780,8,0,0,133,106,36,39,322
8781,8,1,0,132,105,36,41,323
8782,8,0,0,131,106,36,39,320
8783,8,0,0,132,106,36,39,321
8784,7,0,0,131,104,36,39,317
8785,8,0,0,130,106,36,38,318
8786,7,0,0,131,106,37,39,320
8787,7,1,0,129,105,37,38,317
8788,7,0,0,129,105,37,38,316
8789,7,0,0,129,104,36,38,314
8790,7,0,0,129,106,37,38,317
8791,7,0,0,130,106,36,39,318
8792,7,1,0,128,103,37,39,315
8793,7,0,0,127,105,36,39,314
8794,7,0,0,75,106,36,38,262
8795,7,0,0,1,105,37,39,189
8796,7,0,0,0,106,36,38,187
8797,7,1,0,1,107,37,38,191
8798,7,0,0,1,106,38,38,190
8799,7,0,0,0,106,37,39,189
8800,7,1,0,0,105,37,38,188
8801,7,0,0,0,106,36,38,187
8802,7,0,0,0,106,36,38,187
8803,7,1,0,0,106,36,38,188
8804,7,0,0,0,105,37,38,187
8805,7,0,0,0,106,37,39,189
8806,7,0,0,1,106,38,39,191
8807,7,1,0,0,105,37,38,188
8808,7,0,0,0,106,37,39,189
8809,7,1,0,0,106,36,38,188
8810,7,1,0,0,105,37,39,189
8811,7,1,0,0,106,36,39,189
8812,7,0,0,148,105,37,39,336
8813,7,0,0,133,106,36,38,320
8814,7,0,0,129,106,37,39,318
8815,7,0,0,127,106,36,38,314
8816,7,0,0,125,106,38,39,315
8817,7,0,0,125,106,37,39,314
8818,7,1,0,124,104,36,38,310
8819,7,1,0,124,105,36,38,311
8820,7,0,0,123,106,37,38,311
8821,7,0,0,123,106,37,39,312
8822,7,0,0,0,106,36,38,187
8823,7,0,0,0,106,36,39,188
8824,7,0,0,0,104,36,38,185
8825,331,1,0,0,106,36,39,513
8826,330,0,0,0,106,35,293,764
8827,329,0,0,0,106,37,279,751
8828,328,0,0,0,106,37,225,696
8829,330,1,0,0,105,36,260,732
8830,330,0,0,0,106,36,234,706
8831,329,0,0,0,106,36,239,710
8832,330,0,0,0,104,36,233,703
8833,329,0,0,0,105,36,273,743
8834,330,0,0,0,105,36,227,698
8835,328,0,0,0,105,36,312,781
8836,329,0,0,0,104,37,234,704
8837,330,0,0,0,106,36,236,708
8838,329,0,0,0,106,36,356,827
8839,329,1,0,0,105,36,325,796
8840,330,1,0,0,106,36,227,700
8841,330,1,0,0,106,36,245,718
8842,330,0,0,0,105,36,253,724
8843,330,0,0,0,105,37,227,699
8844,328,0,0,0,113,1485,358,2284
8845,327,0,0,0,114,1643,312,2396
8846,327,0,0,0,114,1713,219,2373
8847,328,0,0,0,114,1705,223,2370
8848,329,0,0,0,113,1721,248,2411
8849,328,0,0,0,113,1727,227,2395
8850,329,0,0,0,114,1746,209,2398
8851,327,0,0,0,114,1745,237,2423
8852,328,0,0,0,114,1759,222,2423
8853,327,0,0,0,114,1765,269,2475
8854,327,0,0,0,114,1767,295,2503
8855,327,1,0,146,113,1767,239,2593
8856,326,0,0,130,113,1767,222,2558
8857,326,1,0,127,113,1771,223,2561
8858,328,1,0,126,113,1775,253,2596
8859,326,1,0,126,114,1781,287,2635
8860,327,0,0,125,113,1785,391,2741
8861,329,1,0,124,114,1786,232,2586
8862,330,0,0,123,114,1790,222,2579
8863,330,1,0,122,107,1,217,778
8864,328,1,0,122,106,1,225,783
8865,328,0,0,122,107,0,381,938
8866,329,0,0,0,106,1,229,665
8867,328,0,0,0,106,1,230,665
8868,328,1,0,0,106,0,331,766
8869,329,0,0,0,106,0,375,810
8870,329,0,0,0,108,1,305,743
8871,330,0,0,0,107,1,223,661
8872,330,0,0,0,106,1,240,677
8873,330,0,0,0,106,1,208,645
8874,331,0,0,0,106,1,220,658
8875,331,0,0,0,106,1,238,676
8876,331,0,0,0,106,1,253,691
8877,330,1,0,0,107,1,255,694
8878,330,0,0,0,107,1,260,698
8879,332,1,0,0,106,42,263,744
8880,332,0,0,0,106,37,224,699
8881,332,0,0,0,107,38,301,778
8882,331,0,0,0,106,37,216,690
8883,330,1,0,0,107,36,263,737
8884,332,1,0,0,108,37,247,725
8885,332,0,0,0,107,36,231,706
8886,331,0,0,0,106,36,395,868
8887,332,0,0,0,106,36,192,666
8888,331,0,0,0,106,37,308,782
8889,332,1,0,0,106,38,387,864
8890,333,1,0,0,106,36,254,730
8891,331,0,0,0,106,37,258,732
8892,332,0,0,0,106,37,259,734
8893,332,0,0,0,108,38,257,735
8894,332,1,0,0,106,37,192,668
8895,333,1,0,0,106,37,232,709
8896,333,0,0,0,106,36,256,731
8897,332,0,0,0,106,36,308,782
8898,333,1,0,0,106,36,233,709
8899,334,0,0,0,106,36,231,707
8900,333,1,0,147,106,36,274,897
8901,332,0,0,133,106,36,317,924
8902,334,0,0,130,106,36,255,861
8903,334,0,0,127,106,36,387,990
8904,334,0,0,126,107,36,205,808
8905,333,0,0,125,106,36,255,855
8906,334,0,0,124,106,36,310,910
8907,334,1,0,123,106,36,291,891
8908,335,1,0,123,107,37,329,932
8909,336,1,0,122,106,37,331,933
8910,335,0,0,121,105,37,334,932
8911,335,0,0,0,106,37,244,722
8912,337,1,0,0,106,36,310,790
8913,337,0,0,0,106,36,260,739
8914,334,1,0,0,106,38,239,718
8915,334,0,0,10,106,37,281,768
8916,334,1,0,7,106,36,249,733
8917,334,0,0,0,106,37,239,716
8918,333,1,0,0,106,36,275,751
8919,332,1,0,0,106,36,234,709
8920,334,0,0,0,106,36,209,685
8921,334,1,0,0,106,36,281,758
8922,333,0,0,0,106,36,230,705
8923,334,0,0,0,106,37,233,710
8924,334,0,0,0,106,36,229,705
8925,334,0,0,0,106,38,315,793
8926,333,0,0,0,104,37,235,709
8927,334,0,0,0,106,38,298,776
8928,333,0,0,0,105,37,363,838
8929,334,0,0,0,106,36,288,764
8930,336,1,0,0,106,36,263,742
8931,334,0,0,0,107,37,335,813
8932,334,0,0,0,106,36,228,704
8933,334,0,0,0,106,36,277,753
8934,334,0,0,0,106,37,389,866
8935,335,1,0,0,106,36,221,699
8936,335,0,0,0,106,36,270,747
8937,335,0,0,6,106,37,286,770
8938,334,0,0,7,105,37,237,720
8939,335,0,0,7,105,36,216,699
8940,334,1,0,144,105,36,224,844
8941,334,1,0,137,106,37,258,873
8942,334,1,0,134,106,36,306,917
8943,335,0,0,134,105,37,245,856
8944,334,0,0,133,107,36,296,906
8945,331,0,0,132,104,36,251,854
8946,335,0,0,132,105,36,243,851
8947,334,0,0,132,106,37,270,879
8948,334,1,0,131,106,37,225,834
8949,333,1,0,130,106,37,246,853
8950,333,0,0,130,105,38,241,847
8951,332,0,0,130,106,37,385,990
8952,332,0,0,130,106,37,399,1004
8953,333,1,0,129,106,36,382,987
8954,333,0,0,129,106,36,236,840
8955,333,0,0,128,106,37,270,874
8956,333,0,0,127,114,1294,259,2127
8957,333,0,0,127,115,1558,223,2356
8958,333,0,0,129,114,1690,304,2570
8959,333,1,0,127,114,1735,332,2642
8960,333,0,0,127,114,1713,293,2580
8961,331,0,0,6,114,1726,304,2481
8962,333,1,0,7,115,1727,274,2457
8963,332,0,0,6,113,1743,322,2516
8964,333,0,0,6,114,1741,244,2438
8965,334,0,0,8,114,1755,286,2497
8966,335,1,0,0,114,1759,238,2447
8967,333,1,0,0,115,1765,388,2602
8968,334,0,0,0,114,1762,391,2601
8969,334,0,0,0,116,1771,247,2468
8970,334,1,0,0,114,1774,263,2486
8971,334,0,0,153,115,1775,265,2642
8972,334,1,0,137,116,1781,330,2699
8973,335,0,0,129,114,1779,276,2633
8974,334,0,0,128,113,1783,263,2621
8975,334,1,0,128,113,1784,254,2614
8976,335,0,0,125,114,1784,244,2602
8977,335,0,0,124,109,1,233,802
8978,336,0,0,123,107,1,262,829
8979,337,0,0,123,108,1,387,956
8980,337,0,0,122,107,1,357,924
8981,338,0,0,122,108,1,272,841
8982,339,0,0,0,107,0,248,694
8983,340,0,0,0,107,1,232,680
8984,339,1,0,0,107,1,229,677
8985,339,0,0,0,108,1,230,678
8986,339,0,0,0,107,1,228,675
8987,339,0,0,0,107,1,232,679
8988,339,0,0,0,106,1,229,675
8989,339,1,0,0,106,0,230,676
8990,339,0,0,0,108,1,223,671
8991,339,1,0,0,106,1,254,701
8992,340,0,0,0,108,39,250,737
8993,338,0,0,0,106,38,338,820
8994,340,0,0,0,107,38,237,722
8995,339,0,0,0,107,38,250,734
8996,339,0,0,0,107,37,238,721
8997,340,0,0,0,106,36,253,735
8998,340,0,0,0,106,37,239,722
8999,341,1,0,0,107,37,239,725
9000,336,0,0,0,106,37,246,725
9001,335,0,0,0,106,37,266,744
9002,336,1,0,0,107,37,254,735
9003,335,1,0,0,105,38,252,731
9004,7,5,0,0,106,36,37,191
9005,7,10,0,0,106,36,37,196
9006,7,4647,0,1,106,37,38,4836
9007,7,4623,0,0,106,37,38,4811
9008,7,4631,0,0,106,37,38,4819
9009,7,4629,0,1,106,36,38,4817
9010,7,4631,0,0,106,36,38,4818
9011,7,4617,0,1,106,37,38,4806
9012,7,4613,0,0,106,37,38,4801
9013,7,4609,0,0,106,37,38,4797
9014,7,4597,0,1,106,36,38,4785
9015,7,4599,0,1,106,36,38,4787
9016,7,239,0,0,105,37,39,427
9017,7,234,0,143,106,38,37,565
9018,7,4838,0,130,106,37,38,5156
9019,7,4617,0,128,106,37,38,4933
9020,7,241,0,127,106,37,38,556
9021,7,234,0,126,107,36,38,548
9022,7,4614,0,125,106,36,38,4926
9023,7,234,0,124,115,1270,39,1789
9024,7,231,0,123,115,1562,38,2076
9025,7,4671,0,126,114,1679,37,6634
9026,7,4596,0,124,114,1731,38,6610
9027,7,239,0,0,114,1721,38,2119
9028,7,236,0,0,114,1729,38,2124
9029,7,241,0,1,115,1733,38,2135
9030,7,238,0,0,115,1746,38,2144
9031,7,243,0,0,114,1753,38,2155
9032,7,246,0,0,114,1763,38,2168
9033,7,245,0,0,114,1759,38,2163
9034,7,239,0,0,114,1771,38,2169
9035,7,244,0,0,114,1763,38,2166
9036,7,250,0,0,114,1769,38,2178
9037,7,0,0,0,114,1769,38,1928
9038,7,0,0,0,115,1777,37,1936
9039,7,0,0,0,114,1781,38,1940
9040,7,1,0,0,114,1785,38,1945
9041,7,0,0,1,113,1782,38,1941
9042,7,0,0,0,114,1786,38,1945
9043,7,0,0,0,114,1783,38,1942
9044,7,1,0,0,114,1786,38,1946
9045,7,1,0,0,114,1785,38,1945
9046,7,0,0,0,113,1792,38,1950
9047,7,1,0,0,107,1,37,153
9048,7,0,0,1,107,1,38,154
9049,7,0,0,0,107,0,38,152
9050,7,0,0,0,106,1,37,151
9051,7,1,0,1,107,1,37,154
9052,7,0,0,0,107,1,38,153
9053,7,0,0,0,107,1,38,153
9054,7,0,0,0,106,1,38,152
9055,7,1,0,0,107,1,38,154
9056,7,0,0,0,106,1,37,151
9057,7,0,0,1,107,1,38,154
9058,7,0,0,0,107,1,38,153
9059,7,1,0,1,107,1,39,156
9060,7,0,0,0,106,1,38,152
9061,7,0,0,142,106,1,37,293
9062,7,0,0,138,106,38,37,326
9063,7,1,0,129,106,38,38,319
9064,7,0,0,127,106,38,38,316
9065,7,0,0,126,106,38,38,315
9066,7,1,0,126,107,37,38,316
9067,7,0,0,125,108,38,37,315
9068,7,1,0,124,107,37,38,314
9069,7,1,0,123,107,37,38,313
9070,7,1,0,122,107,38,38,313
9071,7,0,0,0,106,37,38,188
9072,7,0,0,0,106,38,37,188
9073,7,0,0,0,107,37,38,189
9074,7,0,0,0,106,38,38,189
9075,7,0,0,0,107,37,38,189
9076,7,0,0,0,107,37,38,189
9077,7,0,0,0,114,1111,38,1270
9078,7,0,0,0,115,1559,37,1718
9079,7,0,0,0,115,1682,38,1842
9080,7,0,0,0,114,1741,38,1900
9081,7,0,0,0,115,1728,38,1888
9082,7,0,0,0,114,1734,38,1893
9083,7,0,0,0,116,1742,38,1903
9084,7,0,0,0,115,1751,38,1911
9085,7,0,0,0,115,1752,37,1911
9086,7,1,0,7,115,1766,38,1934
9087,7,0,0,0,114,1766,38,1925
9088,7,0,0,0,114,1773,38,1932
9089,7,0,0,1,115,1778,38,1939
9090,7,0,0,0,115,1779,38,1939
9091,7,0,0,0,115,1779,38,1939
9092,7,0,0,0,113,1782,37,1939
9093,7,1,0,0,114,1792,39,1953
9094,7,1,0,1,114,1787,38,1948
9095,7,0,0,0,115,1789,38,1949
9096,7,0,0,0,115,1790,38,1950
9097,7,0,0,0,114,1789,38,1948
9098,7,0,0,0,114,1797,39,1957
9099,7,0,0,0,115,1793,38,1953
9100,7,0,0,1,114,1794,38,1954
9101,7,0,0,148,114,1794,38,2101
9102,7,0,0,135,114,1802,38,2096
9103,7,0,0,129,115,1801,38,2090
9104,7,0,0,127,114,1795,37,2080
9105,7,0,0,127,114,1800,38,2086
9106,7,0,0,126,109,1,38,281
9107,7,0,0,125,106,1,38,277
9108,7,0,0,124,108,1,38,278
9109,7,1,0,123,107,1,38,277
9110,7,0,0,122,106,1,38,274
9111,7,0,0,0,107,1,38,153
9112,7,0,0,0,107,1,38,153
9113,7,0,0,1,108,1,37,154
9114,7,1,0,7,108,1,38,162
9115,7,1,0,7,106,1,37,159
9116,7,0,0,7,106,1,38,159
9117,7,1,0,7,108,1,38,162
9118,7,0,0,7,106,1,38,159
9119,7,0,0,7,107,1,38,160
9120,7,0,0,7,108,0,38,160
9121,7,0,0,7,106,42,38,200
9122,7,0,0,7,107,38,38,197
9123,7,0,0,7,106,37,38,195
9124,7,1,0,7,106,37,38,196
9125,7,0,0,154,106,38,38,343
9126,7,0,0,141,106,37,39,330
9127,7,1,0,137,106,38,38,327
9128,7,0,0,137,107,37,37,325
9129,7,0,0,135,107,37,38,324
9130,7,0,0,133,108,38,38,324
9131,7,1,0,133,107,37,38,323
9132,7,0,0,133,107,38,38,323
9133,7,0,0,132,106,37,38,320
9134,7,0,0,132,106,37,37,319
9135,7,0,0,131,108,38,38,322
9136,7,0,0,131,107,37,38,320
9137,7,0,0,131,106,37,38,319
9138,7,0,0,130,107,38,38,320
9139,7,0,0,131,107,38,38,321
9140,7,0,0,129,106,37,38,317
9141,7,1,0,129,115,1391,39,1682
9142,7,0,0,128,116,1616,37,1904
9143,7,0,0,128,114,1709,38,1996
9144,7,0,0,125,115,1746,38,2031
9145,7,0,0,39,115,1736,38,1935
9146,7,1,0,0,115,1747,38,1908
9147,7,1,0,1,115,1746,38,1908
9148,7,1,0,0,115,1752,38,1913
9149,7,1,0,0,114,1762,38,1922
9150,7,0,0,0,114,1769,38,1928
9151,7,1,0,1,114,1770,38,1931
9152,7,0,0,1,115,1779,38,1940
9153,7,1,0,0,115,1777,38,1938
9154,7,0,0,1,115,1784,38,1945
9155,7,0,0,0,115,1779,37,1938
9156,7,1,0,0,115,1783,39,1945
9157,7,1,0,1,115,1786,38,1948
9158,7,0,0,0,113,1791,38,1949
9159,7,0,0,0,114,1791,38,1950
9160,7,0,0,1,115,1790,38,1951
9161,7,1,0,0,114,1791,38,1951
9162,7,0,0,0,115,1792,38,1952
9163,7,0,0,0,115,1795,39,1956
9164,7,0,0,0,114,1792,37,1950
9165,7,0,0,0,115,1793,38,1953
9166,7,0,0,0,114,1805,38,1964
9167,7,0,0,0,115,1809,38,1969
9168,7,0,0,0,115,1803,38,1963
9169,7,0,0,1,115,1803,38,1964
9170,7,1,0,0,114,1808,37,1967
9171,7,0,0,0,114,1799,38,1958
9172,7,0,0,0,114,1808,37,1966
9173,7,1,0,0,108,1,38,155
9174,7,0,0,622,106,1,38,774
9175,7,0,0,141,107,1,38,294
9176,7,0,0,129,107,1,38,282
9177,7,0,0,127,108,1,39,282
9178,7,1,0,128,108,1,38,283
9179,7,0,0,126,107,1,38,279
9180,7,1,0,125,106,0,38,277
9181,7,0,0,125,107,1,38,278
9182,7,2,0,124,107,1,37,278
9183,7,0,0,125,108,1,37,278
9184,7,0,0,0,106,1,38,152
9185,7,0,0,0,107,1,38,153
9186,7,0,0,0,108,1,38,154
9187,7,1,0,1,106,1,38,154
9188,7,0,0,0,107,1,38,153
9189,7,0,0,1,107,41,38,194
9190,7,1,0,0,106,38,38,190
9191,7,0,0,0,107,38,38,190
9192,7,1,0,1,107,38,38,192
9193,7,1,0,0,106,38,38,190
9194,7,0,0,0,107,38,37,189
9195,7,1,0,0,106,38,38,190
9196,7,0,0,0,106,37,39,189
9197,7,0,0,0,108,38,38,191
9198,7,0,0,0,107,38,38,190
9199,7,0,0,0,107,37,38,189
9200,7,1,0,0,107,37,38,190
9201,7,0,0,0,107,37,38,189
9202,7,1,0,0,107,38,38,191
9203,7,0,0,10,106,38,38,199
9204,7,0,0,0,108,38,38,191
9205,7,0,0,0,106,38,38,189
9206,7,0,0,0,106,39,38,190
9207,7,0,0,0,106,38,38,189
9208,7,0,0,0,107,38,38,190
9209,7,0,0,0,107,38,38,190
9210,7,0,0,1,106,37,38,189
9211,7,1,0,0,106,37,38,189
9212,7,1,0,0,106,38,38,190
9213,7,0,0,0,106,38,38,189
9214,7,0,0,0,107,37,38,189
9215,7,1,0,143,106,38,38,333
9216,7,1,0,132,106,38,38,322
9217,7,0,0,128,107,38,38,318
9218,7,0,0,127,115,983,38,1270
9219,7,0,0,127,116,1540,38,1828
9220,7,0,0,127,115,1674,38,1961
9221,7,0,0,125,115,1722,38,2007
9222,7,0,0,123,115,1721,38,2004
9223,7,0,0,123,115,1730,38,2013
9224,7,1,0,122,114,1743,38,2025
9225,7,0,0,0,115,1752,38,1912
9226,7,0,0,0,114,1753,39,1913
9227,7,0,0,0,115,1759,38,1919
9228,7,0,0,0,115,1768,38,1928
9229,7,1,0,1,115,1770,38,1932
9230,7,0,0,0,114,1778,38,1937
9231,7,0,0,0,115,1778,38,1938
9232,7,0,0,0,115,1778,38,1938
9233,7,1,0,0,115,1781,38,1942
9234,7,1,0,0,115,1792,38,1953
9235,7,1,0,0,114,1791,38,1951
9236,7,1,0,0,115,1787,39,1949
9237,7,0,0,0,115,1790,37,1949
9238,7,0,0,0,115,1790,38,1950
9239,7,0,0,1,115,1786,38,1947
9240,7,1,0,0,115,1793,38,1954
9241,7,0,0,0,115,1797,38,1957
9242,7,1,0,1,115,1798,38,1960
9243,7,0,0,0,114,1797,38,1956
9244,7,1,0,0,114,1794,38,1954
9245,7,0,0,0,115,1800,38,1960
9246,7,0,0,0,115,1797,39,1958
9247,7,0,0,0,115,1795,38,1955
9248,7,1,0,0,113,1791,38,1950
9249,7,0,0,0,115,1797,39,1958
9250,7,1,0,0,115,1810,37,1970
9251,7,1,0,1,114,1805,38,1966
9252,7,0,0,0,115,1797,38,1957
9253,7,0,0,0,114,1806,38,1965
9254,7,1,0,0,114,1807,38,1967
9255,7,0,0,1,114,1803,38,1963
9256,7,1,0,0,113,1803,38,1962
9257,7,0,0,1,114,1805,38,1965
9258,7,0,0,0,115,1807,38,1967
9259,7,0,0,0,114,1805,38,1964
9260,7,0,0,148,113,1798,38,2104
9261,7,0,0,136,107,1,39,290
9262,7,0,0,130,107,1,38,283
9263,7,0,0,128,108,1,38,282
9264,7,0,0,132,107,1,37,284
9265,7,1,0,128,107,1,38,282
9266,7,0,0,126,108,1,38,280
9267,7,1,0,125,107,1,38,279
9268,7,1,0,124,107,1,38,278
9269,7,1,0,123,107,1,38,277
9270,7,0,0,123,107,1,38,276
9271,7,0,0,0,107,1,38,153
9272,7,0,0,0,108,1,38,154
9273,7,0,0,0,108,1,38,154
9274,7,0,0,0,107,1,38,153
9275,7,0,0,0,106,1,38,152
9276,7,0,0,0,106,1,38,152
9277,7,0,0,0,106,41,38,192
9278,7,0,0,0,106,38,38,189
9279,7,0,0,0,106,38,38,189
9280,7,1,0,0,106,37,38,189
9281,7,0,0,0,106,38,39,190
9282,7,0,0,0,108,38,38,191
9283,7,0,0,0,106,38,37,188
9284,7,0,0,0,106,37,38,188
9285,7,0,0,1,107,38,38,191
9286,7,1,0,0,106,38,39,191
9287,7,0,0,0,106,38,38,189
9288,7,0,0,0,107,37,38,189
9289,7,0,0,0,107,38,38,190
9290,7,0,0,1,107,37,38,190
9291,7,0,0,1,107,38,39,192
9292,7,0,0,0,107,37,38,189
9293,7,0,0,0,107,38,38,190
9294,7,0,0,0,106,37,38,188
9295,7,0,0,7,108,37,38,197
9296,8,1,0,7,108,38,38,200
9297,7,0,0,7,106,37,39,196
9298,7,0,0,7,106,37,38,195
9299,7,1,0,7,106,36,38,195
9300,7,0,0,153,106,38,38,342
9301,7,0,0,140,106,37,38,328
9302,7,1,0,137,106,37,38,326
9303,7,0,0,135,115,1496,38,1791
9304,7,0,0,134,115,1657,38,1951
9305,7,0,0,133,115,1730,38,2023
9306,7,0,0,132,115,1718,38,2010
9307,7,0,0,132,115,1727,38,2019
9308,7,0,0,132,114,1747,38,2038
9309,7,0,0,131,114,1751,38,2041
9310,7,0,0,131,114,1738,38,2028
9311,7,0,0,131,115,1763,38,2054
9312,7,1,0,130,114,1778,38,2068
9313,7,0,0,131,114,1773,38,2063
9314,7,0,0,130,114,1771,37,2059
9315,7,1,0,129,115,1773,38,2063
9316,7,1,0,129,114,1785,38,2074
9317,7,1,0,129,114,1776,37,2064
9318,7,0,0,128,114,1785,38,2072
9319,7,0,0,128,115,1785,38,2073
9320,7,0,0,128,115,1794,38,2082
9321,7,0,0,7,115,1777,38,1944
9322,7,0,0,7,115,1789,38,1956
9323,7,1,0,10,114,1795,38,1965
9324,7,0,0,0,114,1794,37,1952
9325,7,1,0,0,115,1784,37,1944
9326,7,0,0,0,115,1801,38,1961
9327,7,0,0,0,115,1806,38,1966
9328,7,0,0,0,113,1791,38,1949
9329,7,1,0,0,114,1791,39,1952
9330,7,0,0,0,114,1792,38,1951
9331,7,0,0,0,115,1795,38,1955
9332,7,1,0,0,116,1799,38,1961
9333,7,0,0,1418,114,1817,38,3394
9334,7,0,0,142,114,1816,38,2117
9335,7,0,0,129,115,1798,39,2088
9336,7,0,0,127,114,1798,38,2084
9337,7,0,0,126,115,1801,38,2087
9338,7,1,0,125,114,1807,38,2092
9339,7,0,0,125,114,1805,38,2089
9340,7,0,0,124,114,1809,37,2091
9341,7,0,0,123,114,1807,38,2089
9342,7,1,0,122,115,1816,38,2099
9343,7,1,0,1,114,1795,38,1956
9344,7,1,0,0,114,1806,38,1966
9345,7,0,0,1,114,1810,39,1971
9346,7,0,0,0,108,1,38,154
9347,7,0,0,1,108,1,38,155
9348,7,0,0,0,108,1,38,154
9349,7,0,0,0,107,1,38,153
9350,7,0,0,0,107,1,38,153
9351,7,0,0,0,107,0,38,152
9352,7,1,0,0,106,0,38,152
9353,7,0,0,1,107,1,38,154
9354,7,0,0,0,106,0,38,151
9355,7,1,0,0,106,1,39,154
9356,7,0,0,0,106,1,38,152
9357,7,0,0,0,107,1,39,154
9358,8,1,0,0,108,0,38,155
9359,7,0,0,0,106,1,38,152
9360,7,0,0,0,107,1,38,153
9361,7,1,0,0,107,1,38,154
9362,7,0,0,0,106,1,38,152
9363,7,0,0,0,106,39,38,190
9364,7,0,0,1,107,38,38,191
9365,7,0,0,0,108,38,38,191
9366,7,1,0,0,107,38,38,191
9367,7,0,0,0,106,37,38,188
9368,7,0,0,0,107,38,38,190
9369,7,1,0,0,107,37,38,190
9370,7,0,0,0,106,38,39,190
9371,7,1,0,0,106,37,38,189
9372,7,0,0,0,106,37,38,188
9373,7,0,0,0,106,38,38,189
9374,7,0,0,0,108,37,38,190
9375,7,0,0,0,106,36,38,187
9376,7,1,0,0,105,36,38,187
9377,7,0,0,0,106,37,38,188
9378,7,0,0,0,106,36,38,187
9379,7,1,0,0,107,36,38,189
9380,7,0,0,141,106,37,38,329
9381,7,1,0,129,106,36,39,318
9382,7,0,0,127,106,37,37,314
9383,7,1,0,130,107,36,37,318
9384,7,2,0,130,106,37,38,320
9385,7,0,0,125,106,37,37,312
9386,7,0,0,124,107,36,38,312
9387,7,1,0,123,106,36,37,310
9388,7,0,0,122,115,1385,38,1667
9389,7,1,0,121,113,1608,38,1888
9390,7,1,0,0,114,1701,38,1861
9391,7,0,0,0,114,1726,38,1885
9392,7,1,0,0,113,1712,38,1871
9393,7,0,0,0,113,1727,38,1885
9394,7,0,0,0,113,1737,38,1895
9395,7,1,0,0,114,1744,38,1904
9396,7,1,0,0,114,1753,39,1914
9397,7,0,0,0,114,1758,38,1917
9398,7,1,0,0,114,1759,38,1919
9399,7,0,0,0,113,1770,38,1928
9400,7,0,0,1,113,1767,38,1926
9401,7,0,0,0,113,1771,38,1929
9402,7,1,0,0,113,1771,38,1930
9403,7,0,0,0,114,1766,37,1924
9404,7,0,0,0,113,1771,38,1929
9405,7,0,0,0,113,1775,38,1933
9406,7,0,0,0,114,1775,37,1933
9407,7,0,0,0,113,1787,38,1945
9408,7,0,0,0,114,1786,37,1944
9409,7,0,0,0,114,1787,38,1946
9410,7,1,0,0,114,1784,37,1943
9411,7,0,0,0,113,1781,38,1939
9412,7,1,0,0,113,1786,38,1945
9413,7,0,0,0,113,1792,38,1950
9414,7,0,0,0,113,1791,38,1949
9415,7,0,0,0,113,1794,38,1952
9416,7,0,0,1,114,1793,38,1953
9417,7,1,0,0,114,1799,38,1959
9418,7,0,0,0,112,1793,37,1949
9419,7,0,0,0,113,1801,38,1959
9420,7,0,0,0,113,1809,38,1967
9421,7,0,0,0,114,1799,38,1958
9422,7,0,0,0,114,1808,38,1967
9423,7,0,0,0,113,1793,38,1951
9424,7,1,0,0,114,1803,38,1963
9425,7,0,0,0,114,1801,38,1960
9426,7,0,0,0,113,1805,38,1963
9427,7,1,0,143,113,1797,38,2099
9428,7,1,0,130,114,1794,38,2084
9429,7,0,0,127,114,1815,37,2100
9430,7,1,0,126,114,1821,38,2107
9431,7,0,0,125,114,1806,37,2089
9432,7,0,0,124,113,1801,38,2083
9433,7,0,0,123,114,1799,38,2081
9434,7,1,0,123,107,1,38,277
9435,7,0,0,122,106,1,37,273
9436,7,0,0,122,107,1,38,275
9437,7,1,0,0,106,1,37,152
9438,7,0,0,0,107,1,37,152
9439,7,0,0,0,107,1,38,153
9440,7,0,0,0,107,0,38,152
9441,7,0,0,0,107,1,38,153
9442,7,0,0,0,107,1,38,153
9443,7,0,0,0,107,1,38,153
9444,7,0,0,10,107,1,38,163
9445,7,0,0,7,108,1,37,160
9446,7,0,0,1,107,1,38,154
9447,7,0,0,0,106,1,38,152
9448,7,1,0,0,107,1,38,154
9449,7,0,0,0,106,1,38,152
9450,7,0,0,0,106,39,38,190
9451,7,1,0,0,107,38,38,191
9452,7,0,0,0,107,39,38,191
9453,7,0,0,0,106,37,38,188
9454,7,0,0,0,107,38,38,190
9455,7,0,0,0,106,38,38,189
9456,7,0,0,0,106,37,38,188
9457,7,0,0,0,106,36,38,187
9458,7,0,0,0,106,38,37,188
9459,7,1,0,0,106,36,38,188
9460,7,0,0,0,106,37,38,188
9461,7,1,0,0,106,36,38,188
9462,7,0,0,0,106,38,38,189
9463,7,0,0,0,107,36,38,188
9464,7,1,0,0,107,36,38,189
9465,7,1,0,0,107,37,38,190
9466,7,0,0,0,106,36,38,187
9467,7,1,0,0,115,1357,38,1518
9468,7,0,0,145,114,1681,38,1985
9469,7,0,0,132,114,1686,38,1977
9470,7,1,0,129,114,1727,38,2016
9471,7,0,0,127,115,1743,38,2030
9472,7,1,0,127,115,1762,38,2050
9473,7,1,0,125,114,1738,38,2023
9474,7,0,0,124,114,1741,38,2024
9475,7,0,0,124,113,1753,39,2036
9476,7,0,0,124,114,1760,38,2043
9477,7,0,0,126,114,1762,37,2046
9478,7,0,0,7,114,1771,38,1937
9479,7,0,0,7,115,1774,38,1941
9480,7,0,0,7,114,1782,38,1948
9481,7,0,0,7,114,1784,38,1950
9482,7,1,0,7,113,1779,38,1945
9483,7,1,0,7,115,1786,37,1953
9484,7,0,0,7,113,1790,38,1955
9485,7,0,0,7,114,1791,37,1956
9486,7,1,0,7,113,1782,38,1948
9487,7,0,0,7,114,1795,38,1961
9488,7,0,0,7,113,1795,38,1960
9489,7,0,0,150,114,1798,38,2107
9490,7,1,0,138,114,1790,37,2087
9491,7,0,0,136,114,1808,38,2103
9492,7,1,0,134,114,1803,38,2097
9493,7,0,0,133,114,1798,38,2090
9494,7,1,0,135,114,1793,38,2088
9495,7,0,0,132,114,1805,38,2096
9496,7,0,0,132,113,1797,39,2088
9497,7,0,0,132,115,1821,38,2113
9498,7,1,0,131,113,1811,38,2101
9499,7,0,0,131,114,1808,38,2098
9500,7,0,0,130,113,1795,38,2083
9501,7,1,0,129,113,1798,38,2086
9502,7,1,0,130,114,1810,38,2100
9503,7,0,0,130,114,1808,38,2097
9504,7,0,0,129,115,1809,37,2097
9505,7,1,0,132,114,1811,38,2103
9506,7,0,0,126,114,1811,39,2097
9507,7,0,0,124,114,1815,37,2097
9508,7,0,0,0,114,1813,38,1972
9509,7,0,0,0,115,1814,38,1974
9510,7,0,0,0,108,1,38,154
9511,7,0,0,0,108,1,38,154
9512,7,0,0,0,107,1,38,153
9513,7,0,0,0,108,1,38,154
9514,7,0,0,0,107,1,38,153
9515,7,1,0,0,107,1,37,153
9516,7,0,0,0,107,1,38,153
9517,7,1,0,0,107,0,38,153
9518,7,1,0,0,106,0,38,152
9519,7,0,0,0,107,1,37,152
9520,7,1,0,0,107,1,38,154
9521,7,1,0,0,106,1,39,154
9522,7,1,0,0,106,1,38,153
9523,7,0,0,0,107,1,38,153
9524,7,0,0,0,106,1,38,152
9525,7,1,0,0,107,1,37,153
9526,7,0,0,0,106,39,38,190
9527,7,0,0,0,106,37,38,188
9528,7,0,0,0,106,36,38,187
9529,7,0,0,0,106,38,38,189
9530,7,0,0,1,106,38,38,190
9531,7,0,0,0,106,36,38,187
9532,7,1,0,1,107,36,37,189
9533,7,1,0,1,105,36,38,188
9534,7,0,0,1,106,35,38,187
9535,7,0,0,1,106,36,38,188
9536,7,0,0,1,106,36,38,188
9537,7,0,0,1,114,1633,38,1793
9538,7,0,0,1,114,1674,38,1834
9539,7,0,0,145,114,1719,37,2022
9540,7,1,0,131,114,1755,37,2045
9541,7,0,0,128,113,1757,38,2043
9542,7,0,0,127,115,1733,38,2020
9543,7,1,0,127,115,1741,38,2029
9544,7,0,0,124,114,1735,38,2018
9545,7,1,0,125,114,1771,38,2056
9546,7,0,0,122,113,1769,38,2049
9547,7,0,0,123,114,1768,38,2050
9548,7,0,0,122,115,1782,37,2063
9549,7,2,0,0,114,1783,37,1943
9550,7,0,0,1,114,1787,38,1947
9551,5,1,0,1,114,1793,38,1952
9552,7,0,0,1,114,1793,38,1953
9553,7,0,0,0,114,1797,38,1956
9554,7,0,0,0,113,1794,38,1952
9555,7,0,0,0,114,1800,38,1959
9556,7,0,0,79,113,1808,38,2045
9557,7,0,0,0,114,1798,37,1956
9558,7,0,0,0,114,1811,37,1969
9559,7,0,0,0,113,1808,38,1966
9560,7,0,0,0,114,1807,38,1966
9561,7,0,0,1,113,1811,38,1970
9562,7,0,0,0,113,1816,38,1974
9563,7,1,0,0,113,1808,38,1967
9564,7,0,0,79,113,1816,37,2052
9565,7,0,0,10,113,1823,38,1991
9566,7,0,0,10,114,1816,37,1984
9567,7,0,0,0,106,1,37,151
9568,7,0,0,0,106,1,37,151
9569,7,0,0,0,107,1,38,153
9570,7,0,0,0,108,1,39,155
9571,7,0,0,0,107,1,38,153
9572,7,1,0,0,107,0,38,153
9573,7,1,0,0,106,1,37,152
9574,7,0,0,0,107,1,37,152
9575,7,1,0,0,106,1,37,152
9576,7,2,0,0,106,1,38,154
9577,7,1,0,0,107,1,37,153
9578,7,0,0,142,108,1,37,295
9579,7,0,0,129,106,1,38,281
9580,7,1,0,128,107,1,38,282
9581,7,0,0,126,106,1,38,278
9582,7,0,0,125,107,1,38,278
9583,7,0,0,124,107,37,38,313
9584,7,0,0,124,106,37,37,311
9585,7,0,0,122,106,37,37,309
9586,7,0,0,122,106,37,38,310
9587,7,0,0,121,106,38,37,309
9588,7,0,0,0,106,36,38,187
9589,7,0,0,0,106,37,38,188
9590,7,0,0,0,106,36,38,187
9591,7,1,0,0,107,36,38,189
9592,7,0,0,0,105,35,37,184
9593,7,0,0,0,106,36,37,186
9594,7,0,0,0,106,36,38,187
9595,7,1,0,1,106,37,38,190
9596,7,0,0,0,106,37,38,188
9597,7,1,0,0,106,37,38,189
9598,7,0,0,0,106,37,38,188
9599,7,2,0,0,105,36,38,188
9600,7,0,0,1,106,37,38,189
9601,7,1,0,0,106,36,38,188
9602,7,0,0,0,106,35,38,186
9603,7,0,0,0,106,37,38,188
9604,7,0,0,0,108,37,38,190
9605,7,0,0,0,106,36,38,187
9606,7,1,0,0,115,1529,37,1689
9607,7,0,0,0,114,1675,38,1834
9608,7,0,0,0,114,1721,37,1879
9609,7,0,0,0,115,1738,38,1898
9610,7,0,0,1,115,1755,37,1915
9611,7,0,0,1,113,1765,38,1924
9612,7,0,0,0,115,1738,38,1898
9613,7,0,0,0,115,1751,37,1910
9614,7,0,0,0,115,1767,38,1927
9615,7,0,0,10,115,1773,38,1943
9616,7,0,0,7,115,1774,38,1941
9617,7,1,0,7,114,1785,38,1952
9618,7,0,0,7,115,1800,38,1967
9619,7,1,0,155,114,1805,38,2120
9620,7,0,0,139,115,1801,38,2100
9621,338,1,0,136,114,1805,38,2432
9622,334,0,0,134,114,1813,202,2597
9623,334,1,0,133,114,1802,266,2650
9624,331,1,0,132,113,1813,271,2661
9625,332,0,0,132,114,1815,322,2715
9626,334,1,0,132,114,1813,332,2726
9627,334,0,0,132,114,1817,291,2688
9628,334,0,0,131,113,1808,276,2662
9629,334,0,0,131,114,1837,233,2649
9630,335,0,0,130,114,1818,269,2666
9631,336,1,0,130,108,1,254,830
9632,336,0,0,130,107,1,283,857
9633,336,0,0,129,107,1,288,861
9634,334,0,0,128,107,0,283,852
9635,337,0,0,129,107,0,282,855
9636,336,0,0,128,107,0,224,795
9637,337,0,0,128,107,0,279,851
9638,336,1,0,128,107,1,301,874
9639,336,0,0,127,107,0,274,844
9640,339,1,0,7,108,1,268,724
9641,337,0,0,7,106,1,286,737
9642,339,0,0,7,106,1,286,739
9643,338,1,0,10,108,1,290,748
9644,337,0,0,0,107,1,284,729
9645,337,0,0,0,106,1,292,736
9646,335,1,0,0,107,1,266,710
9647,336,0,0,0,106,1,263,706
9648,334,0,0,0,107,38,207,686
9649,335,0,0,0,106,37,233,711
9650,334,0,0,0,105,37,224,700
9651,337,0,0,151,107,38,243,876
9652,335,0,0,138,107,38,222,840
9653,336,1,0,128,106,37,294,902
9654,336,0,0,127,107,37,283,890
9655,335,0,0,126,107,38,270,876
9656,335,1,0,125,106,38,284,889
9657,337,0,0,124,107,37,277,882
9658,337,0,0,123,106,37,279,882
9659,336,0,0,122,106,37,271,872
9660,335,1,0,121,106,37,279,879
9661,335,0,0,0,106,36,267,744
9662,336,0,0,0,106,37,247,726
9663,335,0,0,0,107,36,245,723
9664,334,0,0,0,106,37,234,711
9665,336,0,0,0,107,38,262,743
9666,336,0,0,0,107,37,245,725
9667,334,0,0,0,107,36,260,737
9668,335,1,0,0,106,38,257,737
9669,331,0,0,0,106,37,249,723
9670,332,0,0,0,106,36,270,744
9671,334,0,0,0,107,36,280,757
9672,333,0,0,0,106,36,261,736
9673,334,0,0,0,107,36,260,737
9674,335,0,0,0,107,37,258,737
9675,335,0,0,0,106,38,259,738
9676,335,1,0,0,107,36,254,733
9677,334,0,0,0,106,37,263,740
9678,334,0,0,0,107,36,262,739
9679,332,0,0,0,107,38,247,724
9680,334,1,0,0,107,36,270,748
9681,333,1,0,0,106,36,414,890
9682,333,0,0,0,106,36,253,728
9683,331,1,0,0,106,36,275,749
9684,332,1,0,0,107,36,425,901
9685,7,0,0,0,107,37,48,199
9686,7,0,0,0,107,37,49,200
9687,7,0,0,0,107,37,49,200
9688,7,0,0,0,108,38,49,202
9689,7,0,0,0,107,37,49,200
9690,7,1,0,0,107,37,48,200
9691,7,0,0,0,106,38,48,199
9692,7,0,0,0,106,36,49,198
9693,7,1,0,0,106,37,49,200
9694,7,0,0,0,107,37,48,199
9695,7,1,0,0,108,37,49,202
9696,7,0,0,0,107,38,49,201
9697,7,1,0,146,107,36,48,345
9698,7,1,0,137,107,35,49,336
9699,7,0,0,128,107,37,49,328
9700,7,1,0,127,107,37,49,328
9701,7,0,0,126,106,36,49,324
9702,7,0,0,125,107,37,48,324
9703,7,1,0,128,107,37,49,329
9704,7,1,0,126,106,38,49,327
9705,7,0,0,125,106,37,38,313
9706,7,0,0,123,106,38,38,312
9707,7,0,0,122,108,37,38,312
9708,7,0,0,1,107,36,38,189
9709,7,1,0,0,108,36,38,190
9710,7,0,0,0,107,36,38,188
9711,7,0,0,0,106,37,38,188
9712,7,0,0,0,106,37,38,188
9713,7,1,0,0,106,37,38,189
9714,7,0,0,0,107,37,38,189
9715,7,1,0,0,107,37,38,190
9716,7,0,0,1,106,36,38,188
9717,7,1,0,0,106,38,37,189
9718,7,0,0,0,107,36,37,187
9719,7,0,0,0,106,36,38,187
9720,7,0,0,0,106,37,38,188
9721,7,0,0,0,106,37,38,188
9722,7,0,0,0,106,36,38,187
9723,7,0,0,0,106,38,38,189
9724,7,0,0,1,106,38,38,190
9725,7,0,0,0,107,38,38,190
9726,7,0,0,0,106,37,38,188
9727,7,0,0,0,106,37,38,188
9728,7,0,0,0,106,36,38,187
9729,7,0,0,0,106,37,37,187
9730,7,1,0,0,114,1416,38,1576
9731,7,0,0,0,114,1627,38,1786
9732,7,0,0,0,115,1736,38,1896
9733,7,0,0,0,114,1741,38,1900
9734,7,0,0,0,114,1773,38,1932
9735,7,1,0,1,115,1773,39,1936
9736,7,0,0,0,115,1790,37,1949
9737,7,0,0,1,114,1809,38,1969
9738,7,0,0,0,114,1803,38,1962
9739,7,0,0,0,114,1810,38,1969
9740,7,0,0,0,115,1831,38,1991
9741,7,0,0,0,115,1814,38,1974
9742,7,0,0,0,114,1839,38,1998
9743,7,1,0,0,114,1831,37,1990
9744,7,0,0,144,114,1843,38,2146
9745,7,0,0,132,114,1831,38,2122
9746,7,1,0,128,114,1843,38,2131
9747,7,1,0,127,114,1824,37,2110
9748,7,0,0,127,114,1851,39,2138
9749,7,0,0,124,115,1851,38,2135
9750,7,0,0,125,107,1,38,278
9751,7,1,0,123,106,1,37,275
9752,7,0,0,122,107,1,38,275
9753,7,0,0,122,107,1,38,275
9754,7,1,0,0,106,1,38,153
9755,7,0,0,0,107,1,37,152
9756,7,1,0,1,107,1,38,155
9757,7,0,0,0,107,1,37,152
9758,7,0,0,0,108,1,38,154
9759,7,0,0,0,106,1,39,153
9760,7,0,0,0,107,1,37,152
9761,7,0,0,0,106,1,38,152
9762,7,1,0,0,107,1,38,154
9763,7,0,0,0,108,1,38,154
9764,7,0,0,7,107,1,38,160
9765,7,1,0,0,106,0,37,151
9766,7,1,0,0,108,1,37,154
9767,7,1,0,0,106,1,38,153
9768,7,0,0,0,107,1,38,153
9769,7,0,0,0,107,1,38,153
9770,7,0,0,0,107,42,38,194
9771,7,0,0,1,106,39,38,191
9772,7,0,0,0,106,38,38,189
9773,7,1,0,0,107,38,38,191
9774,7,0,0,1,106,38,38,190
9775,7,0,0,0,107,37,38,189
9776,7,0,0,0,106,38,38,189
9777,7,1,0,0,107,37,37,189
9778,7,1,0,0,107,36,38,189
9779,7,0,0,0,106,37,38,188
9780,7,1,0,1,108,36,38,191
9781,7,0,0,0,108,37,38,190
9782,7,0,0,0,106,37,38,188
9783,7,0,0,0,106,37,38,188
9784,7,0,0,0,107,37,38,189
9785,7,0,0,145,107,36,38,333
9786,7,0,0,132,107,37,38,321
9787,7,0,0,127,106,37,38,315
9788,7,0,0,127,106,36,37,313
9789,7,0,0,126,106,36,38,313
9790,7,0,0,125,107,37,38,314
9791,7,0,0,124,106,37,38,312
9792,7,1,0,123,108,38,37,314
9793,7,0,0,125,106,36,38,312
9794,7,0,0,126,106,38,37,314
9795,7,0,0,7,106,36,38,194
9796,7,0,0,7,107,36,38,195
9797,7,0,0,7,107,37,38,196
9798,7,1,0,7,107,38,38,198
9799,7,0,0,7,107,37,38,196
9800,7,0,0,7,107,38,38,197
9801,7,0,0,7,107,38,38,197
9802,7,0,0,7,107,36,38,195
9803,7,0,0,7,107,36,38,195
9804,7,0,0,7,108,38,38,198
9805,7,1,0,7,107,36,37,195
9806,7,0,0,151,106,38,38,340
9807,7,1,0,138,107,36,38,327
9808,7,0,0,135,106,37,37,322
9809,7,0,0,136,108,37,38,326
9810,7,0,0,135,107,36,38,323
9811,7,0,0,133,106,38,38,322
9812,7,1,0,133,107,35,38,321
9813,7,0,0,132,107,37,38,321
9814,7,0,0,132,107,36,38,320
9815,7,0,0,131,107,37,38,320
9816,7,0,0,131,107,36,38,319
9817,7,1,0,130,108,37,38,321
9818,7,0,0,130,107,36,38,318
9819,7,0,0,129,106,36,38,316
9820,7,0,0,130,107,35,38,317
9821,7,1,0,130,107,38,38,321
9822,7,0,0,132,106,37,38,320
9823,7,1,0,126,106,36,38,314
9824,7,0,0,124,106,36,38,311
9825,7,0,0,0,108,37,38,190
9826,7,0,0,0,107,36,38,188
9827,7,0,0,0,106,36,38,187
9828,7,0,0,0,107,36,38,188
9829,7,1,0,0,107,37,38,190
9830,7,0,0,0,107,37,38,189
9831,7,2,0,1,107,38,38,193
9832,7,1,0,0,107,37,38,190
9833,7,0,0,0,107,36,39,189
9834,7,1,0,0,107,36,38,189
9835,7,0,0,1,107,37,38,190
9836,7,0,0,0,107,36,38,188
9837,7,1,0,0,107,37,38,190
9838,7,0,0,0,106,37,38,188
9839,7,0,0,0,107,38,39,191
9840,7,0,0,0,106,37,38,188
9841,7,0,0,0,106,36,38,187
9842,7,0,0,0,107,37,38,189
9843,7,0,0,0,107,37,38,189
9844,7,1,0,0,106,37,37,188
9845,7,0,0,0,106,37,38,188
9846,7,2,0,0,106,36,38,189
9847,7,0,0,0,106,37,38,188
9848,7,1,0,0,107,36,38,189
9849,7,1,0,0,108,36,37,189
9850,7,0,0,0,106,37,38,188
9851,7,0,0,0,106,38,37,188
9852,7,0,0,0,106,38,38,189
9853,7,1,0,1,106,36,38,189
9854,7,1,0,0,107,37,38,190
9855,7,0,0,0,107,37,37,188
9856,7,0,0,144,107,36,38,332
9857,7,0,0,131,107,37,38,320
9858,7,0,0,128,108,37,38,318
9859,7,1,0,127,108,37,38,318
9860,7,0,0,125,107,37,38,314
9861,7,1,0,124,107,36,38,313
9862,7,0,0,124,108,37,38,314
9863,7,0,0,123,106,37,38,311
9864,7,0,0,122,106,37,39,311
9865,7,1,0,122,106,38,38,312
9866,7,1,0,0,106,38,38,190
9867,7,0,0,1,107,37,38,190
9868,7,0,0,0,107,36,38,188
9869,7,0,0,0,106,36,38,187
9870,7,0,0,0,106,36,38,187
9871,7,0,0,0,108,36,38,189
9872,7,0,0,0,106,38,38,189
9873,7,0,0,1,108,38,38,192
9874,7,0,0,0,108,38,38,191
9875,7,1,0,0,107,38,38,191
9876,7,0,0,1,107,37,38,190
9877,7,0,0,0,107,36,38,188
9878,7,2,0,0,106,37,38,190
9879,7,0,0,0,106,37,37,187
9880,7,0,0,0,107,37,38,189
9881,7,0,0,0,106,37,38,188
9882,7,0,0,10,106,37,38,198
9883,7,0,0,10,107,36,37,197
9884,7,0,0,0,106,36,38,187
9885,7,0,0,0,107,36,38,188
9886,7,2,0,0,108,37,38,192
9887,7,0,0,0,106,37,37,187
9888,7,1,0,0,107,36,38,189
9889,7,0,0,0,108,36,38,189
9890,7,0,0,0,108,37,38,190
9891,7,0,0,0,106,37,38,188
9892,7,0,0,0,106,37,38,188
9893,7,1,0,0,106,38,38,190
9894,7,0,0,1,108,36,38,190
9895,7,0,0,0,107,36,37,187
9896,7,0,0,143,106,38,38,332
9897,7,1,0,139,107,38,38,330
9898,7,0,0,129,106,37,38,317
9899,7,0,0,127,107,36,38,315
9900,7,1,0,126,107,37,38,316
9901,7,1,0,125,106,36,38,313
9902,7,1,0,125,106,37,38,314
9903,7,0,0,123,107,36,38,311
9904,7,1,0,124,108,36,38,314
9905,7,0,0,122,106,36,38,309
9906,7,0,0,0,107,36,38,188
9907,7,0,0,1,106,37,38,189
9908,7,1,0,0,107,36,38,189
9909,7,0,0,0,108,36,38,189
9910,7,0,0,0,107,38,37,189
9911,7,0,0,0,107,37,38,189
9912,7,0,0,0,107,37,37,188
9913,7,0,0,1,107,37,38,190
9914,7,2,0,0,107,37,38,191
9915,7,0,0,0,108,37,37,189
9916,7,1,0,0,108,37,38,191
9917,7,0,0,0,107,36,38,188
9918,7,1,0,0,108,38,38,192
9919,7,0,0,0,107,38,38,190
9920,7,1,0,0,107,37,38,190
9921,7,0,0,0,106,37,38,188
9922,7,0,0,0,108,36,38,189
9923,7,0,0,0,107,38,38,190
9924,7,2,0,1,107,38,38,193
9925,7,0,0,1,107,38,38,191
9926,7,1,0,0,108,37,38,191
9927,7,0,0,0,108,37,38,190
9928,7,0,0,0,107,38,38,190
9929,7,1,0,0,108,38,38,192
9930,7,1,0,0,108,37,38,191
9931,7,1,0,1,107,37,39,192
9932,7,2,0,0,107,36,37,189
9933,7,0,0,0,107,38,38,190
9934,7,1,0,0,108,36,38,190
9935,7,1,0,0,107,36,38,189
9936,7,1,0,0,107,37,38,190
9937,7,0,0,0,107,36,38,188
9938,7,0,0,0,107,36,39,189
9939,7,0,0,0,107,37,38,189
9940,7,1,0,0,108,37,38,191
9941,7,1,0,0,108,37,38,191
9942,7,0,0,1,106,37,38,189
9943,7,0,0,147,107,37,38,336
9944,7,0,0,140,107,37,38,329
9945,7,0,0,132,108,38,38,323
9946,7,1,0,128,107,36,37,316
9947,7,0,0,128,108,38,38,319
9948,7,0,0,127,108,36,38,316
9949,7,0,0,126,108,38,38,317
9950,7,0,0,125,107,37,38,314
9951,7,0,0,123,107,37,38,312
9952,7,0,0,122,108,37,38,312
9953,7,0,0,205,106,37,38,393
9954,7,0,0,0,107,37,38,189
9955,7,0,0,1,107,37,38,190
9956,7,1,0,0,108,37,38,191
9957,7,1,0,10,108,37,38,201
9958,7,0,0,7,107,38,38,197
9959,7,0,0,7,108,37,38,197
9960,7,0,0,7,107,37,37,195
9961,7,0,0,7,106,37,38,195
9962,7,0,0,7,107,38,38,197
9963,7,1,0,7,108,38,37,198
9964,7,0,0,7,107,37,38,196
9965,7,0,0,7,107,38,38,197
9966,7,2,0,7,107,37,38,198
9967,7,0,0,7,107,37,38,196
9968,7,1,0,149,107,37,39,340
9969,7,0,0,138,107,37,38,327
9970,7,0,0,138,106,38,37,326
9971,7,0,0,136,107,37,38,325
9972,7,0,0,135,108,38,38,326
9973,7,0,0,135,107,36,38,323
9974,7,0,0,134,107,38,38,324
9975,7,1,0,134,108,37,38,325
9976,7,0,0,132,109,37,38,323
9977,7,0,0,132,108,38,38,323
9978,7,0,0,132,107,37,37,320
9979,7,0,0,131,107,37,38,320
9980,7,1,0,132,109,37,38,324
9981,7,0,0,132,106,37,38,320
9982,7,0,0,132,107,38,39,323
9983,7,0,0,131,108,38,38,322
9984,7,0,0,130,106,38,38,319
9985,7,2,0,130,106,38,37,320
9986,8,0,0,130,108,39,39,324
9987,7,1,0,129,109,38,38,322
9988,7,0,0,129,107,37,39,319
9989,7,0,0,128,107,37,39,318
9990,7,0,0,127,106,38,38,316
9991,7,0,0,0,108,37,37,189
9992,7,0,0,1,108,37,38,191
9993,7,0,0,0,107,37,37,188
9994,7,2,0,1,107,37,38,192
9995,8,0,0,0,107,36,37,188
9996,7,0,0,0,107,37,38,189
9997,7,0,0,0,107,37,37,188
9998,7,0,0,0,106,36,38,187
9999,7,1,0,1,107,37,38,191
10000,7,0,0,0,108,38,38,191
10001,7,0,0,0,106,38,38,189
10002,7,1,0,0,108,37,38,191
10003,7,0,0,1,107,35,38,188
10004,7,1,0,1,108,37,37,191
10005,7,0,0,1,106,37,38,189
10006,7,1,0,0,107,38,39,192
10007,7,0,0,0,106,37,38,188
10008,7,0,0,0,106,37,38,188
10009,7,0,0,0,107,37,38,189
10010,7,0,0,0,106,37,38,188
10011,7,0,0,0,106,37,38,188
10012,7,1,0,0,107,37,38,190
10013,7,0,0,147,107,37,38,336
10014,7,0,0,131,106,38,38,320
10015,7,0,0,127,106,37,38,315
10016,7,0,0,126,107,38,38,316
10017,7,0,0,125,106,38,38,314
10018,7,1,0,124,106,36,38,312
10019,7,1,0,124,106,36,38,312
10020,7,0,0,122,105,36,37,307
10021,7,0,0,122,106,36,38,309
10022,7,0,0,122,106,37,37,309
10023,7,0,0,1,106,37,38,189
10024,7,0,0,0,106,37,38,188
10025,7,0,0,0,106,37,38,188
10026,7,0,0,0,106,38,38,189
10027,7,0,0,0,106,37,38,188
10028,7,0,0,0,107,36,38,188
10029,7,0,0,0,106,36,38,187
10030,7,1,0,0,107,37,38,190
10031,7,0,0,0,106,38,38,189
10032,335,0,0,0,105,36,265,741
10033,334,0,0,0,107,37,214,692
10034,335,0,0,0,107,37,267,746
10035,335,1,0,0,106,37,282,761
10036,335,0,0,0,106,37,361,839
10037,334,0,0,0,107,36,416,893
10038,7,0,0,0,106,36,266,415
10039,7,0,0,0,105,37,236,385
10040,7,0,0,0,106,36,267,416
10041,7,1,0,0,106,36,295,445
10042,7,0,0,0,108,37,281,433
10043,7,0,0,0,106,38,264,415
10044,7,1,0,0,107,38,289,442
10045,7,0,0,0,107,37,276,427
10046,7,1,0,0,106,37,254,405
10047,7,0,0,0,106,36,315,464
10048,7,0,0,0,106,36,258,407
10049,7,0,0,0,106,36,282,431
10050,7,0,0,10,107,37,278,439
10051,7,1,0,0,107,37,277,429
10052,7,0,0,0,107,36,282,432
10053,7,0,0,0,106,37,293,443
10054,7,0,0,0,107,37,289,440
10055,7,0,0,0,107,37,291,442
10056,7,1,0,0,107,36,293,444
10057,7,0,0,141,107,37,274,566
10058,7,0,0,132,107,36,244,526
10059,7,0,0,127,107,38,219,498
10060,7,1,0,127,107,37,228,507
10061,7,1,0,125,107,36,240,516
10062,7,1,0,126,107,37,231,509
10063,7,0,0,126,107,36,251,527
10064,7,0,0,123,107,37,418,692
10065,7,1,0,122,107,36,378,651
10066,7,1,0,121,107,37,308,581
10067,7,0,0,0,107,37,288,439
10068,7,0,0,0,108,36,317,468
10069,7,0,0,0,106,37,314,464
10070,7,0,0,1,106,36,278,428
10071,7,1,0,0,107,36,231,382
10072,7,0,0,81,106,37,253,484
10073,7,0,0,0,106,37,240,390
10074,7,0,0,0,107,36,247,397
10075,7,0,0,0,108,36,237,388
10076,7,0,0,1,108,37,254,407
10077,7,0,0,0,106,37,250,400
10078,7,0,0,0,107,37,264,415
10079,7,0,0,0,106,37,258,408
10080,7,0,0,0,108,36,249,400
